CDR3b	epitope	source
CASSELPGPPGEQYF	SPRWYFYYL	unknown
CASSQDGLSETQYF	SPRWYFYYL	unknown
CASSDRPLGPNTEAFF	SPRWYFYYL	unknown
CASSEGQDNYGYTF	SPRWYFYYL	unknown
CASSYLAGGYNEQFF	SPRWYFYYL	unknown
CASSPLTGTGSDKETQYF	SPRWYFYYL	unknown
CASSLKTGGSTEAFF	SPRWYFYYL	unknown
CASSPRETANSGANVLTF	SPRWYFYYL	unknown
CASSHLVGSAIAKNIQYF	SPRWYFYYL	unknown
CASSPLVGSALAKNIQYF	SPRWYFYYL	unknown
CASSALAGGPPEGKNIQYF	SPRWYFYYL	unknown
CASSEKPLSSYNEQFF	SPRWYFYYL	unknown
CSARGGDSAYEQYF	SPRWYFYYL	unknown
CASSPLAGHPSTKNIQYF	SPRWYFYYL	unknown
CATSTGGQPQHF	SPRWYFYYL	unknown
CASSLEAGRSPYEQYF	SPRWYFYYL	unknown
CASSSKQGPGELFF	SPRWYFYYL	unknown
CASSIFSASGSVTDTQYF	SPRWYFYYL	unknown
CASSERTGGSTEAFF	SPRWYFYYL	unknown
CASSLGVFTGAGNQPQHF	SPRWYFYYL	unknown
CASSVGSGLQYYEQYF	SPRWYFYYL	unknown
CASSLALLAGAGGELFF	SPRWYFYYL	unknown
CASSALAGGPDNEQFF	SPRWYFYYL	unknown
CAWSPITSNYGYTF	SPRWYFYYL	unknown
CSARAYRESAQYF	SPRWYFYYL	unknown
CASSYFQSSGGGYTF	SPRWYFYYL	unknown
CASSRFPTGSNNEQFF	SPRWYFYYL	unknown
CASRAKVGAANEQFF	SPRWYFYYL	unknown
CASSLGQGHFTF	SPRWYFYYL	unknown
CASSERDSPGNVLTF	SPRWYFYYL	unknown
CASSQDQGGAEAFF	SPRWYFYYL	unknown
CASSLFAGAQGNQPQHF	SPRWYFYYL	unknown
CASSQRGLAGAPSYNEQFF	SPRWYFYYL	unknown
CASSEGLAGTNTGELFF	SPRWYFYYL	unknown
CASSERASPGNVLTF	SPRWYFYYL	unknown
CSAGTRDKYYEQYF	SPRWYFYYL	unknown
CASSSLTSGGARYTQYF	SPRWYFYYL	unknown
CASRPLTGGDQPQHF	SPRWYFYYL	unknown
CASRRLTGGQQPQHF	SPRWYFYYL	unknown
CASSSLTSGGARYTQYF	SPRWYFYYL	unknown
CASSSITGDRVRKETQYF	SPRWYFYYL	unknown
CASSDLRTANTEAFF	SPRWYFYYL	unknown
CASSSLTSGAYNEQFF	SPRWYFYYL	unknown
CASSSLTGSSGELFF	SPRWYFYYL	unknown
CASSQDAGTAHVGEQFF	SPRWYFYYL	unknown
CASSFLTGPKGDYTF	SPRWYFYYL	unknown
CATSDLTQDEQYF	SPRWYFYYL	unknown
CASSQGGAIQYF	SPRWYFYYL	unknown
CATSDLPGKAGYTF	SPRWYFYYL	unknown
CASSLPPREQYF	SPRWYFYYL	unknown
CASSPLAGVPLAAKNIQYF	SPRWYFYYL	unknown
CASSQNRNRALNTEAFF	SPRWYFYYL	unknown
CASSQGGSSSEKLFF	SPRWYFYYL	unknown
CASSWGGRGGYEQYF	SPRWYFYYL	unknown
CASSVLPASGAGRNEQFF	SPRWYFYYL	unknown
CASRAITGSGQPQHF	SPRWYFYYL	unknown
CASKALVGTAEAKNIQYF	SPRWYFYYL	unknown
CASAPLVGAPEAKNIQYF	SPRWYFYYL	unknown
CASRPLAGGQDKETQYF	SPRWYFYYL	unknown
CASSPLAGGEEKKETQYF	SPRWYFYYL	unknown
CASSFTSGGARRKETQYF	SPRWYFYYL	unknown
CASSYLPGGAKTEAFF	SPRWYFYYL	unknown
CASSTLATNEKLFF	SPRWYFYYL	unknown
CASSFIEGSPNTEAFF	SPRWYFYYL	unknown
CASSLNRANTEAFF	SPRWYFYYL	unknown
CASRKITGGPNQPQHF	SPRWYFYYL	unknown
CASSLITSAIYEQYF	SPRWYFYYL	unknown
CSARTETGELFF	SPRWYFYYL	unknown
CASSRIRDYTDTQYF	SPRWYFYYL	unknown
CASTPRGNPGDEQFF	SPRWYFYYL	unknown
CASSPLRQAKIEAFF	SPRWYFYYL	unknown
CASSLGTSQFF	SPRWYFYYL	unknown
CATSSGIGAGATDTQYF	SPRWYFYYL	unknown
CASSALAGGFNEQFF	SPRWYFYYL	unknown
CASSLIISAGDTEAFF	SPRWYFYYL	unknown
CASSQGLAGATSTDTQYF	SPRWYFYYL	unknown
CASSRTARAYEQYF	SPRWYFYYL	unknown
CASSPIAGLKVNEQFF	SPRWYFYYL	unknown
CASSPIITGGNYGYTF	SPRWYFYYL	unknown
CASSSLLGGPQPQHF	SPRWYFYYL	unknown
CASSPLTSSSYNEQFF	SPRWYFYYL	unknown
CASSSLVGKQEAKNIQYF	SPRWYFYYL	unknown
CSARGSDHFYTEAFF	SPRWYFYYL	unknown
CATSDLTQDTQYF	SPRWYFYYL	unknown
CASSPAVGDPLAKNIQYF	SPRWYFYYL	unknown
CASLAGETQYF	SPRWYFYYL	unknown
CASSFSLGHPTDTQYF	SPRWYFYYL	unknown
CASSPSTGHPEAKNIQYF	SPRWYFYYL	unknown
CASSQTTKDEQYF	KTFPPTEPK	unknown
CASSQGQKDEQYF	KTFPPTEPK	unknown
CASSQFTGRKEKLFF	KTFPPTEPK	unknown
CASSEKARGNEQFF	KTFPPTEPK	unknown
CATDRNTEAFF	KTFPPTEPK	unknown
CASSPRQGDTQYF	KTFPPTEPK	unknown
CASSTKGPNNEQFF	KTFPPTEPK	unknown
CASSVLSGGPFNEQFF	KTFPPTEPK	unknown
CASSLPSGQGAYNEQFF	KTFPPTEPK	unknown
CASSLAKKDTQYF	KTFPPTEPK	unknown
CASSQVASSEAFF	YLQPRTFLL	unknown
CASSPKGAGADYGYTF	YLQPRTFLL	unknown
CASSEAPWGTGELFF	YLQPRTFLL	unknown
CASMLADTQYF	YLQPRTFLL	unknown
CSARDLDRPNTEAFF	YLQPRTFLL	unknown
CASSWIIAEEQFF	YLQPRTFLL	unknown
CASSEERTGRQETQYF	SPRWYFYYL	unknown
CATRDRVTLWTNEKLFF	SPRWYFYYL	unknown
CASSPGQGKDTQYF	SPRWYFYYL	unknown
CATRGGSYNSPLHF	SPRWYFYYL	unknown
CASSPRDRGYEQYF	SPRWYFYYL	unknown
CASGGAGRDYGYTF	SPRWYFYYL	unknown
CASSLLAGATDTQYF	SPRWYFYYL	unknown
CASSTWTFYNSPLHF	SPRWYFYYL	unknown
CSARGQRSYNEQFF	SPRWYFYYL	unknown
CATTVPGLAYNEQFF	YLQPRTFLL	unknown
CASSQQGGYEQFF	SPRWYFYYL	unknown
CATRVLARSTDTQYF	SPRWYFYYL	unknown
CAWSEGTSGGDEQYF	YLQPRTFLL	unknown
CASSLYLTSEQYF	YLQPRTFLL	unknown
CSVLGGVNEQFF	SPRWYFYYL	unknown
CASSPSWGKNIQYF	SPRWYFYYL	unknown
CASRQGANNEQFF	YLQPRTFLL	unknown
CATSRQSGPTLNSGNTIYF	SPRWYFYYL	unknown
CASSEGAWAGNTIYF	SPRWYFYYL	unknown
CASSAGQNSYEQYF	SPRWYFYYL	unknown
CASGASSYNEQFF	SPRWYFYYL	unknown
CASSQRRDTQYF	SPRWYFYYL	unknown
CASSVGLAGYTGELFF	SPRWYFYYL	unknown
CASSPLWDRGPLSYGYTF	SPRWYFYYL	unknown
CSASDSINQPQHF	SPRWYFYYL	unknown
CSARDRSSYNEQFF	SPRWYFYYL	unknown
CASSSRAQETQYF	YLQPRTFLL	unknown
CASSRLAGEGPGELFF	SPRWYFYYL	unknown
CSVSGGYGYTF	SPRWYFYYL	unknown
CASSISVHWRESYNEQFF	SPRWYFYYL	unknown
CASSLGLSSNEQFF	SPRWYFYYL	unknown
CASSSPGQGLPYEQYF	SPRWYFYYL	unknown
CASSFRTSGRRYEQYF	SPRWYFYYL	unknown
CASSLLQGDSPLHF	YLQPRTFLL	unknown
CASSLNRGGGSYGYTF	SPRWYFYYL	unknown
CASSSTGEWNQPQHF	SPRWYFYYL	unknown
CASSSETFGNTIYF	SPRWYFYYL	unknown
CATSRSGTSGVNEQFF	SPRWYFYYL	unknown
CASSMGGFYEQYF	YLQPRTFLL	unknown
CASSSGQLATEAFF	SPRWYFYYL	unknown
CASSDHRSGASTDTQYF	YLQPRTFLL	unknown
CASSDFQGPNYGYTF	YLQPRTFLL	unknown
CASSQRTGGSGELFF	YLQPRTFLL	unknown
CASSLWASSEQYF	YLQPRTFLL	unknown
CATSGTSGAPSYNEQFF	YLQPRTFLL	unknown
CASSFIASTDTQYF	SPRWYFYYL	unknown
CASSSQGGEQYF	SPRWYFYYL	unknown
CASSHSLAGGSNEQFF	KTFPPTEPK	unknown
CASSQEATRFSQGYEQYF	KTFPPTEPK	unknown
CASSLASGSQPQHF	KTFPPTEPK	unknown
CSARAADNSYEQYF	KTFPPTEPK	unknown
CASSYSPLVNWPLHF	KTFPPTEPK	unknown
CASSFLPRYVEQYF	KTFPPTEPK	unknown
CAWNHPATGGPTDTQYF	KTFPPTEPK	unknown
CASSLAGIIYRGYTF	KTFPPTEPK	unknown
CASRLWGRNEQFF	KTFPPTEPK	unknown
CASSERGNQPQHF	KTFPPTEPK	unknown
CSARDLGTAYGYTF	KTFPPTEPK	unknown
CASSRVSGPFKETQYF	KTFPPTEPK	unknown
CASSSSYSGNTIYF	KTFPPTEPK	unknown
CASSLGTQNYEQYF	KTFPPTEPK	unknown
CASSPRVSGNTIYF	KTFPPTEPK	unknown
CASSYGRESGNTIYF	KTFPPTEPK	unknown
CASSYSDRGNSPLHF	KTFPPTEPK	unknown
CASSETSGRTSEQYF	KTFPPTEPK	unknown
CSAPDRAPNSPLHF	KTFPPTEPK	unknown
CASSGGNGELFF	KTFPPTEPK	unknown
CASSYVGLAGPTDTQYF	KTFPPTEPK	unknown
CASSGLAGGPQELFF	SPRWYFYYL	unknown
CASSFSSSGPNEQFF	SPRWYFYYL	unknown
CASSRQAVGSHEQYF	SPRWYFYYL	unknown
CASSPFGGGSGELFF	SPRWYFYYL	unknown
CSARETINYNEQFF	SPRWYFYYL	unknown
CSANDRGRGYNSPLHF	QYIKWPWYI	unknown
CASSLELGNYGYTF	QYIKWPWYI	unknown
CASLGGTPYNEQFF	QYIKWPWYI	unknown
CASSLGRDSSYNSPLHF	QYIKWPWYI	unknown
CASSVSVRGGTEAFF	QYIKWPWYI	unknown
CASSLVAGGSDTQYF	QYIKWPWYI	unknown
CASRTGTAYNEQFF	QYIKWPWYI	unknown
CSVLWSGREGEQFF	QYIKWPWYI	unknown
CASSFGSRNTEAFF	QYIKWPWYI	unknown
CASSLKGQGFINEQFF	QYIKWPWYI	unknown
CASKREGSSYEQYF	QYIKWPWYI	unknown
CATSDLSGTYTGELFF	SPRWYFYYL	unknown
CASSLVLGSGRKQFF	SPRWYFYYL	unknown
CASSANEQFF	SPRWYFYYL	unknown
CASSHQQGSGTEAFF	SPRWYFYYL	unknown
CASSLSGNSNQPQHF	SPRWYFYYL	unknown
CASTDSGTISYEQYF	SPRWYFYYL	unknown
CASSEGIHPPEQFF	SPRWYFYYL	unknown
CASSEWQGEKLFF	YLQPRTFLL	unknown
CASSEWQGEKLFF	YLQPRTFLL	unknown
CASSPNRGLDSYEQYF	YLQPRTFLL	unknown
CASSEWQGEKLFF	YLQPRTFLL	unknown
CASSFGTTDTQYF	YLQPRTFLL	unknown
CASSEWQGEKLFF	YLQPRTFLL	unknown
CASSEWQGEKLFF	YLQPRTFLL	unknown
CASSEWQGEKLFF	YLQPRTFLL	unknown
CASSEWQGEKLFF	YLQPRTFLL	unknown
CASSEWQGEKLFF	YLQPRTFLL	unknown
CASSEGDEQYF	YLQPRTFLL	unknown
CASSRDYNEQFF	YLQPRTFLL	unknown
CASRDRDSYEQYF	YLQPRTFLL	unknown
CASSSPGTGNSPLHF	KTFPPTEPK	unknown
CSATPWGGSYEQYF	KTFPPTEPK	unknown
CASSEWGPNTEAFF	KTFPPTEPK	unknown
CAWSDRGETQYF	KTFPPTEPK	unknown
CASSGPGNQPQHF	KTFPPTEPK	unknown
CASSQSGNGHYGYTF	KTFPPTEPK	unknown
CASSRAAGSKDTQYF	KTFPPTEPK	unknown
CASSIRDAPLEQYF	KTFPPTEPK	unknown
CASSFSGYMNTEAFF	KTFPPTEPK	unknown
CASSETGTGGYEQYF	KTFPPTEPK	unknown
CAWSVTGGSYEQYF	KTFPPTEPK	unknown
CASSPPPTGPQETQYF	KTFPPTEPK	unknown
CASSLEGHEQYF	KTFPPTEPK	unknown
CAIRAGTGGDEQYF	KTFPPTEPK	unknown
CSAPWDSPEETQYF	KTFPPTEPK	unknown
CASSLEGVSSPLHF	KTFPPTEPK	unknown
CASDTGHAYEQYF	KTFPPTEPK	unknown
CASSYNAENQPQHF	KTFPPTEPK	unknown
CASSLTPTGDSYEQYF	KTFPPTEPK	unknown
CSARIHPLYYEQYF	KTFPPTEPK	unknown
CASSQLEGGPSSYEQYF	KTFPPTEPK	unknown
CASSYSKGFTGELFF	KTFPPTEPK	unknown
CATSIRAPETQYF	KTFPPTEPK	unknown
CSALRQGPNTEAFF	KTFPPTEPK	unknown
CSARAGWPAKAAGELFF	KTFPPTEPK	unknown
CATARRTGTDTQYF	KTFPPTEPK	unknown
CASSQGGGKAEAFF	KTFPPTEPK	unknown
CASSWPGLAVDEQFF	KTFPPTEPK	unknown
CASSTLSTGTLYQPQHF	KTFPPTEPK	unknown
CSARASGGHKQYEQYF	KTFPPTEPK	unknown
CASSYLNSPLHF	KTFPPTEPK	unknown
CASSGGTPTGELFF	KTFPPTEPK	unknown
CASSLQGNYEQYF	SPRWYFYYL	unknown
CASSLQGNYEQYF	SPRWYFYYL	unknown
CASSLQGNYEQYF	SPRWYFYYL	unknown
CASSLQGNYEQYF	SPRWYFYYL	unknown
CASSLQGNYEQYF	SPRWYFYYL	unknown
CASSLQGNYEQYF	SPRWYFYYL	unknown
CASSLQGNYEQYF	SPRWYFYYL	unknown
CASSPAGRGFGSPLHF	SPRWYFYYL	unknown
CASSLQGNYEQYF	SPRWYFYYL	unknown
CASSLQGNYEQYF	SPRWYFYYL	unknown
CASSLQGNYEQYF	SPRWYFYYL	unknown
CASSLQGNYEQYF	SPRWYFYYL	unknown
CATSDPHSSESPGRNEQFF	SPRWYFYYL	unknown
CASSPLTGGPNEQFF	SPRWYFYYL	unknown
CASSQDPVARYEQYF	SPRWYFYYL	unknown
CASSLQGNYEQYF	SPRWYFYYL	unknown
CASSPLPTARAAYEQYF	SPRWYFYYL	unknown
CASSLQGNYEQYF	SPRWYFYYL	unknown
CASSLQGNYEQYF	SPRWYFYYL	unknown
CASSLQGNYEQYF	SPRWYFYYL	unknown
CASSILPSGATSSYNEQFF	SPRWYFYYL	unknown
CASSPLTGYNTEAFF	SPRWYFYYL	unknown
CASSQKPGQGGLNEQFF	SPRWYFYYL	unknown
CASSLQGNYEQYF	SPRWYFYYL	unknown
CASSLQGNYEQYF	SPRWYFYYL	unknown
CASSLQGNYEQYF	SPRWYFYYL	unknown
CASSFKQGALSSYNEQFF	SPRWYFYYL	unknown
CASSLQGNYEQYF	SPRWYFYYL	unknown
CASSLQGNYEQYF	SPRWYFYYL	unknown
CASSLQGNYEQYF	SPRWYFYYL	unknown
CASSPKRAVQNYGYTF	SPRWYFYYL	unknown
CASSGQGNYEQYF	SPRWYFYYL	unknown
CASSYSDGTEAFF	KTFPPTEPK	unknown
CASSFYKSEGYTF	SPRWYFYYL	unknown
CASSARTVNTEAFF	KTFPPTEPK	unknown
CASNNDRYTGELFF	SPRWYFYYL	unknown
CASSHRDRDGKLFF	KTFPPTEPK	unknown
CSARANPTVVIEYTEAFF	KTFPPTEPK	unknown
CASSPGQGGSNEQFF	SPRWYFYYL	unknown
CASSLVGGHQPQHF	KTFPPTEPK	unknown
CASSPTEKYGYTF	KTFPPTEPK	unknown
CASRGLVLNNEQFF	KTFPPTEPK	unknown
CASSYVLFRGSEKLFF	KTFPPTEPK	unknown
CASSQVPGGGYNEQFF	SPRWYFYYL	unknown
CASSPSIAGDSYNEQFF	KTFPPTEPK	unknown
CSARDRRVDSRNTGELFF	SPRWYFYYL	unknown
CASSQEYRGSSYNEQFF	KTFPPTEPK	unknown
CASSWGTDGYTF	KTFPPTEPK	unknown
CASSSETSGGFTDTQYF	KTFPPTEPK	unknown
CSVEDAHTEAFF	KTFPPTEPK	unknown
CASSTRPSGASSYEQYF	KTFPPTEPK	unknown
CAIRTGSLLFYTGELFF	KTFPPTEPK	unknown
CASSRGGYRNYEQYF	SPRWYFYYL	unknown
CAISESYGVEKLFF	KTFPPTEPK	unknown
CATSLLSTGELFF	SPRWYFYYL	unknown
CASSRGFDQPQHF	KTFPPTEPK	unknown
CATSRGPRGADQPQHF	KTFPPTEPK	unknown
CASSPRTGAGTNTEAFF	KTFPPTEPK	unknown
CASSLTRPQGRASYEQYF	SPRWYFYYL	unknown
CASSHPRGANTEAFF	KTFPPTEPK	unknown
CASSVMGDMMGYTF	SPRWYFYYL	unknown
CASSGWDLDNTGELFF	KTFPPTEPK	unknown
CSARYGGARVTEAFF	KTFPPTEPK	unknown
CASSYVGGDYNEQFF	KTFPPTEPK	unknown
CASSARDGYNEQFF	KTFPPTEPK	unknown
CASILSTGKGTEAFF	KTFPPTEPK	unknown
CACWTGDTEAFF	KTFPPTEPK	unknown
CAWAWGSPNEKLFF	KTFPPTEPK	unknown
CATQGANEKLFF	KTFPPTEPK	unknown
CASSEGYGYTF	KTFPPTEPK	unknown
CASSTQGAIPMNTEAFF	KTFPPTEPK	unknown
CASSPSPGGRNGYTF	SPRWYFYYL	unknown
CAWSPPAVLNEKLFF	KTFPPTEPK	unknown
CASSLDRFYEQYF	SPRWYFYYL	unknown
CASSQGTGANNQPQHF	KTFPPTEPK	unknown
CASSQDIGGGSYEQYF	SPRWYFYYL	unknown
CASSPRDGHNSPLHF	KTFPPTEPK	unknown
CASSLPSGGPSSYNEQFF	KTFPPTEPK	unknown
CASSFGGDEKLFF	KTFPPTEPK	unknown
CASSLGAAYYQETQYF	SPRWYFYYL	unknown
CASEATNTGELFF	KTFPPTEPK	unknown
CASSLDFNQPQHF	SPRWYFYYL	unknown
CASSLSYRGNTEAFF	SPRWYFYYL	unknown
CASSLRDRYNSPLHF	SPRWYFYYL	unknown
CASSSLTDGGRYEQYF	SPRWYFYYL	unknown
CASSPTTRGEKLFF	KTFPPTEPK	unknown
CSAGRTSYYGYTF	KTFPPTEPK	unknown
CASSSTPGPYYEQYF	KTFPPTEPK	unknown
CASNSGVYNEQFF	KTFPPTEPK	unknown
CSASSGRGATNEKLFF	KTFPPTEPK	unknown
CASRAQGGRNGYTF	SPRWYFYYL	unknown
CASSPNPGQGRGSIQYF	KTFPPTEPK	unknown
CASTGGVLNTEAFF	KTFPPTEPK	unknown
CASSQIPGVRYEQYF	SPRWYFYYL	unknown
CASRRGGNSPLHF	KTFPPTEPK	unknown
CASSPGLAGGHSSYNEQFF	KTFPPTEPK	unknown
CASSPSYRGNNSPLHF	SPRWYFYYL	unknown
CASSMGARGTKAFF	KTFPPTEPK	unknown
CASKRLARSAVDTQYF	KTFPPTEPK	unknown
CSARILAGGTYEQYF	SPRWYFYYL	unknown
CASRPTGMSNQPQHF	SPRWYFYYL	unknown
CSARDNEQFF	KTFPPTEPK	unknown
CASSVVSGNTIYF	KTFPPTEPK	unknown
CASSGDRAEKLFF	KTFPPTEPK	unknown
CASTGGVLNTEAFF	KTFPPTEPK	unknown
CASIRGDYEQYF	SPRWYFYYL	unknown
CASSFIPGEAFF	KTFPPTEPK	unknown
CSAPHGQGGEQYF	KTFPPTEPK	unknown
CASSGGRWEEKLFF	SPRWYFYYL	unknown
CASSQGKGGYTF	KTFPPTEPK	unknown
CASSELPLGGRDTEAFF	SPRWYFYYL	unknown
CASSHGRSSYNEQFF	KTFPPTEPK	unknown
CASGGRGNSGNTIYF	KTFPPTEPK	unknown
CASSSAGLAGDTQYF	SPRWYFYYL	unknown
CASTGGVLNTEAFF	KTFPPTEPK	unknown
CASSPTHLQAFYGYTF	KTFPPTEPK	unknown
CASSSGQSNQPQHF	KTFPPTEPK	unknown
CASSPGGRGGYGYTF	KTFPPTEPK	unknown
CASSLRGQLNTGELFF	SPRWYFYYL	unknown
CASSFGERVYNEQFF	SPRWYFYYL	unknown
CASSLIAGGPLAKNIQYF	SPRWYFYYL	unknown
CASSEKTGGSTEAFF	SPRWYFYYL	unknown
CSARDIRGWYEQYF	YLQPRTFLL	unknown
CASSYPRGQAHNEQFF	SPRWYFYYL	unknown
CSARQGGEAFF	SPRWYFYYL	unknown
CASIGPNTIYF	SPRWYFYYL	unknown
CASSYPRGQAHNEQFF	SPRWYFYYL	unknown
CASSEFLTPGHRNKYF	SPRWYFYYL	unknown
CASDSLIQPQHF	SPRWYFYYL	unknown
CATSDLNGGGYTF	SPRWYFYYL	unknown
CATGPGQIIHQPQHF	SPRWYFYYL	unknown
CASRRMSFNQPQHF	SPRWYFYYL	unknown
CASSYVPGQSHTEAFF	YLQPRTFLL	unknown
CATGRENEQFF	SPRWYFYYL	unknown
CSARDREVAKNIQYF	SPRWYFYYL	unknown
CASSSGYRDIGAFF	SPRWYFYYL	unknown
CAWVRTEAFF	SPRWYFYYL	unknown
CASGTGEGSYNEQFF	SPRWYFYYL	unknown
CASSQARGLYGYTF	SPRWYFYYL	unknown
CSARDRQVNYNEQFF	SPRWYFYYL	unknown
CASSSKRTVQFYGYTF	SPRWYFYYL	unknown
CSVDRGPEQYF	SPRWYFYYL	unknown
CASSSRQGPYEQYF	QYIKWPWYI	unknown
CASSFYLAGGPSNNEQFF	QYIKWPWYI	unknown
CASSAGSPAYEQYF	YLQPRTFLL	unknown
CASSRGLEYNEQFF	QYIKWPWYI	unknown
CASSQLYSESTDTQYF	YLQPRTFLL	unknown
CASSSPGGGSGYTF	QYIKWPWYI	unknown
CASSAGTGAYGYTF	QYIKWPWYI	unknown
CSARDLGAVYQETQYF	YLQPRTFLL	unknown
CAWIDWAGENEQFF	QYIKWPWYI	unknown
CASSLIGETQYF	QYIKWPWYI	unknown
CAWRGDRDHSTDTQYF	YLQPRTFLL	unknown
CASSLTDRGTEAFF	YLQPRTFLL	unknown
CASSEWRWGGPTDTQYF	YLQPRTFLL	unknown
CASSLTGGSYGYTF	YLQPRTFLL	unknown
CSAREREGGYGYTF	YLQPRTFLL	unknown
CASSQLGRTGAFF	YLQPRTFLL	unknown
CASRHSGSDNEQFF	YLQPRTFLL	unknown
CSASRGGALYNEQFF	YLQPRTFLL	unknown
CASTHFEPNNRPEAFF	YLQPRTFLL	unknown
CASSFMGATEAFF	YLQPRTFLL	unknown
CASRAGGTTGELFF	KTFPPTEPK	unknown
CASSLGVHRGIYITEAFF	KTFPPTEPK	unknown
CASTHKTGELFF	KTFPPTEPK	unknown
CASTHKTGELFF	KTFPPTEPK	unknown
CAAGQDPGNTIYF	KTFPPTEPK	unknown
CASTHKTGELFF	KTFPPTEPK	unknown
CASNPRVASGGPLGEQYF	KTFPPTEPK	unknown
CSSFSITEAFF	KTFPPTEPK	unknown
CSARGQGAGETQYF	KTFPPTEPK	unknown
CASSSAPYGYTF	KTFPPTEPK	unknown
CSVVSITEAFF	KTFPPTEPK	unknown
CATGTKRGGYNEQFF	KTFPPTEPK	unknown
CASSYFRPSTLGTDRDEQFF	KTFPPTEPK	unknown
CASSEGLGELFF	KTFPPTEPK	unknown
CASSPPGTGNFYRAEAFF	KTFPPTEPK	unknown
CASREKTGGSTEAFF	SPRWYFYYL	unknown
CASSLAAGQNNEQFF	KTFPPTEPK	unknown
CASSPMVASSDSTPGTQYF	SPRWYFYYL	unknown
CASSPSTYKYNEQFF	KTFPPTEPK	unknown
CATTQRGSTSGDNEQFF	SPRWYFYYL	unknown
CATSRAGSGVRNEQFF	SPRWYFYYL	unknown
CASSYVALSTDTQYF	KTFPPTEPK	unknown
CASSVEVSAYEQYF	KTFPPTEPK	unknown
CASSETPGGQRGYTF	SPRWYFYYL	unknown
CASSYLPGGNTEAFF	SPRWYFYYL	unknown
CSAAYRDQPYEQYF	SPRWYFYYL	unknown
CSARDTPVGGGIWPQHF	SPRWYFYYL	unknown
CASSPRLGSNYGYTF	KTFPPTEPK	unknown
CASRSPTGELFF	KTFPPTEPK	unknown
CASSWPGRDPKNIQYF	KTFPPTEPK	unknown
CASSLVLGSNEQFF	SPRWYFYYL	unknown
CATSDLGTAEAFF	SPRWYFYYL	unknown
CASRGLASSTDTQYF	SPRWYFYYL	unknown
CASSPVSGGTYNEQFF	KTFPPTEPK	unknown
CASSPHRWQGRGNQPQHF	KTFPPTEPK	unknown
CASSRVARSSGNTIYF	KTFPPTEPK	unknown
CASSHTGSVGNTIYF	SPRWYFYYL	unknown
CASSTSTDTQYF	KTFPPTEPK	unknown
CASSSGTGAWNEQFF	SPRWYFYYL	unknown
CASSLGLTTDTQYF	KTFPPTEPK	unknown
CASSEYPVSPGRKQYF	SPRWYFYYL	unknown
CASSVVGNLYAMAYGYTF	SPRWYFYYL	unknown
CASTPKGGAYNEQFF	SPRWYFYYL	unknown
CASSLSYRGNQPQHF	SPRWYFYYL	unknown
CASSSTETRYGYTF	SPRWYFYYL	unknown
CSAPSPTSGSRETQYF	QYIKWPWYI	unknown
CSARDLGAAYEQYF	QYIKWPWYI	unknown
CSATGGGSRFYEQYF	QYIKWPWYI	unknown
CSARVQGYYEQYF	QYIKWPWYI	unknown
CASKEDGGAYEQYF	QYIKWPWYI	unknown
CASSLMTGAYEQYF	QYIKWPWYI	unknown
CASRQASYEQYF	QYIKWPWYI	unknown
CASSQDGLAASYEQYF	QYIKWPWYI	unknown
CAITDPGSGDEQFF	QYIKWPWYI	unknown
CASSEKTGGSTEAFF	SPRWYFYYL	unknown
CASSQEWTGRTEAFF	SPRWYFYYL	unknown
CASSDWGDDEQFF	YLQPRTFLL	unknown
CAEGNLNTGELFF	YLQPRTFLL	unknown
CASRPLTSSTDTQYF	SPRWYFYYL	unknown
CASSPGHYSNQPQHF	SPRWYFYYL	unknown
CSARENPPSGPYNEQFF	SPRWYFYYL	unknown
CASRPLTSSTDTQYF	SPRWYFYYL	unknown
CATSDLASDEQYF	SPRWYFYYL	unknown
CSVEDGSGELFF	YLQPRTFLL	unknown
CASSIERGGYEQYF	SPRWYFYYL	unknown
CASSQEWTGRTEAFF	SPRWYFYYL	unknown
CASSVGLAGNEQFF	SPRWYFYYL	unknown
CASSLELQPRNQPQHF	SPRWYFYYL	unknown
CASRSGGTEAFF	SPRWYFYYL	unknown
CASSLTPGGSYNEQFF	SPRWYFYYL	unknown
CASSSMTGLNTEAFF	SPRWYFYYL	unknown
CASSERNHLEAFF	YLQPRTFLL	unknown
CASRPLTSSTDTQYF	SPRWYFYYL	unknown
CASRPLTSSTDTQYF	SPRWYFYYL	unknown
CASSQEWTGRTEAFF	SPRWYFYYL	unknown
CSVTGTGLLSETQYF	SPRWYFYYL	unknown
CASSGTSGRNEQYF	SPRWYFYYL	unknown
CASRPLVGRREEKETQYF	SPRWYFYYL	unknown
CASRPLVGRREEKETQYF	SPRWYFYYL	unknown
CASSPLTGLAGEKETQYF	SPRWYFYYL	unknown
CASSERNHLEAFF	YLQPRTFLL	unknown
CASQETNTGELFF	YLQPRTFLL	unknown
CSARDQPAQNTGELFF	YLQPRTFLL	unknown
CASSQSYRGNTEAFF	SPRWYFYYL	unknown
CASSLAAAYEQYF	YLQPRTFLL	unknown
CASRPLGGNTEAFF	SPRWYFYYL	unknown
CASSYSYRANTEAFF	SPRWYFYYL	unknown
CASSRRDSAVKLFF	SPRWYFYYL	unknown
CASSEFPVSSYNSPLHF	SPRWYFYYL	unknown
CASSEFPVSSYNSPLHF	SPRWYFYYL	unknown
CASSWTVGGNQPQHF	SPRWYFYYL	unknown
CASSEFPVSSYNSPLHF	SPRWYFYYL	unknown
CASSQDDGTAATNYGYTF	SPRWYFYYL	unknown
CASSYSYRGNDEQYF	SPRWYFYYL	unknown
CASSLTGYPSTDTQYF	SPRWYFYYL	unknown
CASSYSYRANTEAFF	SPRWYFYYL	unknown
CSARDGTPAHSSYNSPLHF	SPRWYFYYL	unknown
CASSQVHHTLYGYTF	SPRWYFYYL	unknown
CASSTRQGGEQFF	SPRWYFYYL	unknown
CASSQDDGTAATNYGYTF	SPRWYFYYL	unknown
CASITNPHFGGYGYTF	SPRWYFYYL	unknown
CASILNEQFF	SPRWYFYYL	unknown
CASRKGDYPQETQYF	SPRWYFYYL	unknown
CASSLTDSRPTLYGYTF	SPRWYFYYL	unknown
CASSYYRNTEAFF	SPRWYFYYL	unknown
CASSQDDGTAATNYGYTF	SPRWYFYYL	unknown
CASSSLTGSRTGKETQYF	SPRWYFYYL	unknown
CASSSLTGSRTGKETQYF	SPRWYFYYL	unknown
CASSLSYRGNNSPLHF	SPRWYFYYL	unknown
CASSLSYRGNQPQHF	SPRWYFYYL	unknown
CASSLSYRGNTEAFF	SPRWYFYYL	unknown
CASSLSYRGNSPLHF	SPRWYFYYL	unknown
CASSLSYRGNQPQHF	SPRWYFYYL	unknown
CASSLSYRGNQPQHF	SPRWYFYYL	unknown
CASSLSYRGNTEAFF	SPRWYFYYL	unknown
CSASSRDSQNTGELFF	YLQPRTFLL	unknown
CASSPPTGGNTGELFF	YLQPRTFLL	unknown
CATSDLANTEAFF	YLQPRTFLL	unknown
CASSLAYELYEQYF	SPRWYFYYL	unknown
CASSRDRSISGNTIYF	SPRWYFYYL	unknown
CSAGTRDTYYEQYF	SPRWYFYYL	unknown
CASSHQTGAGNQPQHF	SPRWYFYYL	unknown
CASSLSYRGTDTQYF	SPRWYFYYL	unknown
CASSGRGLSSGNTIYF	SPRWYFYYL	unknown
CATSIMGWGRDEQFF	SPRWYFYYL	unknown
CASSLAGTEAFF	SPRWYFYYL	unknown
CASSFRTANQPQHF	SPRWYFYYL	unknown
CASSPGLAASTDTQYF	SPRWYFYYL	unknown
CASSEGVRGGETQYF	SPRWYFYYL	unknown
CASSDPLSGSSYEQYF	SPRWYFYYL	unknown
CASRDDRTGNTIYF	SPRWYFYYL	unknown
CASSEGSPYQETQYF	SPRWYFYYL	unknown
CSAGGRGEAYYEQYF	SPRWYFYYL	unknown
CASSARDRGTSGANVLTF	SPRWYFYYL	unknown
CATSGILGGSNEQFF	SPRWYFYYL	unknown
CSVTQGVEAFF	SPRWYFYYL	unknown
CASSHRQGNTDTQYF	SPRWYFYYL	unknown
CASSKRQGTGELFF	SPRWYFYYL	unknown
CASPKPVLQGSEQYF	SPRWYFYYL	unknown
CATSDLRLGDTQYF	SPRWYFYYL	unknown
CSARHRDNYYGYTF	SPRWYFYYL	unknown
CASSLRLAGGIQETQYF	SPRWYFYYL	unknown
CASSRSSNQPQHF	SPRWYFYYL	unknown
CASESDRTASYEQYF	SPRWYFYYL	unknown
CATSTGGRQPQHF	SPRWYFYYL	unknown
CASSLRQGIGDTQYF	SPRWYFYYL	unknown
CASSQNRGYDSYEQYF	SPRWYFYYL	unknown
CATSTGGRQPQHF	SPRWYFYYL	unknown
CASGDNEQYF	SPRWYFYYL	unknown
CATSTGGRQPQHF	SPRWYFYYL	unknown
CASSSGAGVGDTQYF	SPRWYFYYL	unknown
CATSTGGRQPQHF	SPRWYFYYL	unknown
CATSTGGRQPQHF	SPRWYFYYL	unknown
CASSESYRGNTEAFF	SPRWYFYYL	unknown
CASSESYRGNTEAFF	SPRWYFYYL	unknown
CASSLGWRLEQFF	SPRWYFYYL	unknown
CATSTGGRQPQHF	SPRWYFYYL	unknown
CASSYTTGGRKNEQFF	SPRWYFYYL	unknown
CASSEMAESQETQYF	QYIKWPWYI	unknown
CASSSMTSGSYNEQFF	SPRWYFYYL	unknown
CASSPGTGRYEQYF	SPRWYFYYL	unknown
CASTPGQSSEQYF	SPRWYFYYL	unknown
CASSLRALQGGYGYTF	SPRWYFYYL	unknown
CASSQTGGPLQPQHF	SPRWYFYYL	unknown
CASWGQGSNYGYTF	SPRWYFYYL	unknown
CSVYERERHNEQFF	SPRWYFYYL	unknown
CASTLRDHEQYF	SPRWYFYYL	unknown
CATSDPTGQPQHF	YLQPRTFLL	unknown
CASSLPRRLNNEQFF	SPRWYFYYL	unknown
CASSLISPGTSAYEQYF	SPRWYFYYL	unknown
CASSLIRGLVQASYEQYF	SPRWYFYYL	unknown
CASSQQGQGFDTEAFF	SPRWYFYYL	unknown
CSAPHLGTSGDSYEQYF	SPRWYFYYL	unknown
CASSERLAGIGEQFF	SPRWYFYYL	unknown
CASLEGGEKLFF	SPRWYFYYL	unknown
CSARVLQGTNIYF	YLQPRTFLL	unknown
CASSVGAGNYEQYF	SPRWYFYYL	unknown
CASSIRVGNTEAFF	SPRWYFYYL	unknown
CSVPDRGNTEAFF	SPRWYFYYL	unknown
CASCPRQGYNEQFF	SPRWYFYYL	unknown
CASSLSGSPLHF	SPRWYFYYL	unknown
CASSPITGLAKNIQYF	SPRWYFYYL	unknown
CASSPNLQAGRYF	SPRWYFYYL	unknown
CASSRGLGANVLTF	SPRWYFYYL	unknown
CSVDTRSPSNEQFF	SPRWYFYYL	unknown
CASSQEAGTGNTIYF	SPRWYFYYL	unknown
CSARGIGSYEQYF	QYIKWPWYI	unknown
CASSLHSDRRNIQYF	SPRWYFYYL	unknown
CSVLSSDSYNEQFF	SPRWYFYYL	unknown
CASSFWSSAGYEQYF	SPRWYFYYL	unknown
CATSILDRDQPQHF	QYIKWPWYI	unknown
CSARDRDRAYEQYF	QYIKWPWYI	unknown
CASSQHRAPGNTIYF	SPRWYFYYL	unknown
CASSSRTGAETQYF	QYIKWPWYI	unknown
CAISPSLAGLGETQYF	QYIKWPWYI	unknown
CATSGEAGTSVGGEQFF	SPRWYFYYL	unknown
CASRIGGSAYYEQYF	SPRWYFYYL	unknown
CASSFLTGVNNEQFF	SPRWYFYYL	unknown
CASSELPHRFNYGYTF	QYIKWPWYI	unknown
CASSRRGEGNTGELFF	SPRWYFYYL	unknown
CASSQLNRDTQETQYF	SPRWYFYYL	unknown
CASSLWRRRNEQYF	SPRWYFYYL	unknown
CASSGTGGNEQFF	QYIKWPWYI	unknown
CASSPPPSPRELNTDTQYF	QYIKWPWYI	unknown
CASSLVGFSPLHF	QYIKWPWYI	unknown
CASSTQDSLVLHF	YLQPRTFLL	unknown
CASSADIGAFF	YLQPRTFLL	unknown
CASSTTGGSPLHF	YLQPRTFLL	unknown
CSATVNRDYNEQFF	YLQPRTFLL	unknown
CATRGPNTGELFF	YLQPRTFLL	unknown
CASSQRNTGELFF	YLQPRTFLL	unknown
CSVGEQNTGELFF	YLQPRTFLL	unknown
CARRPPMELFF	YLQPRTFLL	unknown
CASISLNTGELFF	YLQPRTFLL	unknown
CASSFSSGGEQFF	YLQPRTFLL	unknown
CASSDRTTGANVLTF	YLQPRTFLL	unknown
CASSLAGVSHTQYF	YLQPRTFLL	unknown
CSAHRDRNTGELFF	YLQPRTFLL	unknown
CAPGSANTGELFF	YLQPRTFLL	unknown
CATSDLPGQGGFTF	SPRWYFYYL	unknown
CSPKRLPYNEQFF	SPRWYFYYL	unknown
CSAFRPRGLNTQYF	SPRWYFYYL	unknown
CSAFRPRGLNTQYF	SPRWYFYYL	unknown
CATSPLAGGGNEQFF	SPRWYFYYL	unknown
CATSPLAGGGNEQFF	SPRWYFYYL	unknown
CSPKRLPYNEQFF	SPRWYFYYL	unknown
CASSPLTSAAYEQYF	SPRWYFYYL	unknown
CATSPLAGGGNEQFF	SPRWYFYYL	unknown
CATSPLAGGGNEQFF	SPRWYFYYL	unknown
CASSFHRAPGTDTQYF	SPRWYFYYL	unknown
CATSPLAGGGNEQFF	SPRWYFYYL	unknown
CATSDLPGKEGYTF	SPRWYFYYL	unknown
CSAFRPRGLNTQYF	SPRWYFYYL	unknown
CSAFRPRGLNTQYF	SPRWYFYYL	unknown
CSVTGLAEKSATQYF	SPRWYFYYL	unknown
CATSDPKLAGGRNEQFF	SPRWYFYYL	unknown
CSPKRLPYNEQFF	SPRWYFYYL	unknown
CASSFHRAPGTDTQYF	SPRWYFYYL	unknown
CASSTWFNQPQHF	KTFPPTEPK	unknown
CATSRAGKPASNYGYTF	KTFPPTEPK	unknown
CASSPGTSGRNEQFF	KTFPPTEPK	unknown
CATSRAGKPASNYGYTF	KTFPPTEPK	unknown
CATRGGSSTDTQYF	KTFPPTEPK	unknown
CASSRTSGRRKERDEQFF	KTFPPTEPK	unknown
CATRGGSSTDTQYF	KTFPPTEPK	unknown
CASSDRQVMNTEAFF	KTFPPTEPK	unknown
CATGNTGELFF	KTFPPTEPK	unknown
CATRGGSSTDTQYF	KTFPPTEPK	unknown
CASSRSGGWAYEQYF	KTFPPTEPK	unknown
CASSDQTGTNTEAFF	KTFPPTEPK	unknown
CASSPLGKSSYNEQFF	KTFPPTEPK	unknown
CASSGGRNTEAFF	KTFPPTEPK	unknown
CASSSTPDGPSYNEQFF	KTFPPTEPK	unknown
CASSSTPDGPSYNEQFF	KTFPPTEPK	unknown
CASSQGAKDEQYF	KTFPPTEPK	unknown
CASSPGTSGRNEQFF	KTFPPTEPK	unknown
CASSPGDGQQFF	KTFPPTEPK	unknown
CASSTRVLLREQYF	SPRWYFYYL	unknown
CASSSGLGSSDTQYF	SPRWYFYYL	unknown
CASSPRLLISRNGYTF	YLQPRTFLL	unknown
CSAEGGANYEQYF	QYIKWPWYI	unknown
CSARDPSGSSVEQYF	QYIKWPWYI	unknown
CSAAIAASYNEQFF	QYIKWPWYI	unknown
CASSLGSADLYF	QYIKWPWYI	unknown
CSARGNTGPSGPYEQYF	QYIKWPWYI	unknown
CASSGTGPNYGYTF	SPRWYFYYL	unknown
CASSLGSEQYF	SPRWYFYYL	unknown
CTIGRTNTEAFF	SPRWYFYYL	unknown
CAWVAVTSTDTQYF	SPRWYFYYL	unknown
CASRTRGPVYNEQFF	SPRWYFYYL	unknown
CASSPLTGSPVAKNIQYF	SPRWYFYYL	unknown
CASSQELTGSKETQYF	SPRWYFYYL	unknown
CSVRREGPGELFF	SPRWYFYYL	unknown
CASSSITGLAKNIQYF	SPRWYFYYL	unknown
CASSLLLGPPAYGYTF	SPRWYFYYL	unknown
CASSWPMRGEAFF	SPRWYFYYL	unknown
CASMIAGGGADTQYF	SPRWYFYYL	unknown
CASSGLAERNTGELFF	YLQPRTFLL	unknown
CASSNGNTGELFF	YLQPRTFLL	unknown
CATQDMNTGELFF	YLQPRTFLL	unknown
CASLLKLRDTSYEQYF	YLQPRTFLL	unknown
CSVMDSLNTGELFF	YLQPRTFLL	unknown
CASQQGNTGELFF	YLQPRTFLL	unknown
CASNPDRNTGELFF	YLQPRTFLL	unknown
CASSEWLQETQYF	YLQPRTFLL	unknown
CSARDLWGENTGELFF	YLQPRTFLL	unknown
CASRVENTGELFF	YLQPRTFLL	unknown
CASSDVSSGELFF	YLQPRTFLL	unknown
CSARDGQAMNTGELFF	YLQPRTFLL	unknown
CSARNDRGHNTGELFF	YLQPRTFLL	unknown
CASSGNRDRNTGELFF	YLQPRTFLL	unknown
CASRGDREMNTGELFF	YLQPRTFLL	unknown
CASSLDRGRVSTDTQYF	YLQPRTFLL	unknown
CASSPPGLGNTGELFF	YLQPRTFLL	unknown
CASRGGQGMNTGELFF	YLQPRTFLL	unknown
CASRSAEAFF	YLQPRTFLL	unknown
CASPDLNTGELFF	YLQPRTFLL	unknown
CATSRDMRGSVELFF	YLQPRTFLL	unknown
CSARDRVGQNTGELFF	YLQPRTFLL	unknown
CASSDQNTGELFF	YLQPRTFLL	unknown
CAQGDANTGELFF	YLQPRTFLL	unknown
CASSPMGNWGNQPQHF	YLQPRTFLL	unknown
CASSPMGNWGNQPQHF	YLQPRTFLL	unknown
CASSPMGNWGNQPQHF	YLQPRTFLL	unknown
CASSWTTDNEQFF	YLQPRTFLL	unknown
CASSPMGNWGNQPQHF	YLQPRTFLL	unknown
CASSISESSYNEQFF	YLQPRTFLL	unknown
CASSISESSYNEQFF	YLQPRTFLL	unknown
CASSSTTGGGFSGANVLTF	YLQPRTFLL	unknown
CASADLDTGELFF	YLQPRTFLL	unknown
CASGSLNTGELFF	YLQPRTFLL	unknown
CAMRTDPNTGELFF	YLQPRTFLL	unknown
CASSPIAGGNTGELFF	YLQPRTFLL	unknown
CANGDLNSGELFF	YLQPRTFLL	unknown
CAGQEMNTGELFF	YLQPRTFLL	unknown
CASTLDQNTGELFF	YLQPRTFLL	unknown
CASGNLNTGELFF	YLQPRTFLL	unknown
CASSDVTTGELFF	YLQPRTFLL	unknown
CSARDKQGWNTGELFF	YLQPRTFLL	unknown
CASTDANTGELFF	YLQPRTFLL	unknown
CSATRDLNTGELFF	YLQPRTFLL	unknown
CATQTLNTGELFF	YLQPRTFLL	unknown
CSARDPTQQNTGELFF	YLQPRTFLL	unknown
CSARDDRALNTGELFF	YLQPRTFLL	unknown
CATAPLNSYEQYF	YLQPRTFLL	unknown
CAKDDANTGELFF	YLQPRTFLL	unknown
CATGESNTGELFF	YLQPRTFLL	unknown
CASSFGAGTAENTGELFF	YLQPRTFLL	unknown
CASSFGAGTAENTGELFF	YLQPRTFLL	unknown
CASSYANTGELFF	YLQPRTFLL	unknown
CASRSSGEYEQYF	YLQPRTFLL	unknown
CSVEGDRNTGELFF	YLQPRTFLL	unknown
CASSEIAGGDTGELFF	YLQPRTFLL	unknown
CASSYIDSLEAFF	YLQPRTFLL	unknown
CSVETDRNTVEAFF	YLQPRTFLL	unknown
CAWIELNTGELFF	YLQPRTFLL	unknown
CASGELNTGELFF	YLQPRTFLL	unknown
CASSPLFGGNTGELFF	YLQPRTFLL	unknown
CSVSDRNDLVAFF	YLQPRTFLL	unknown
CSVQVLNTGELFF	YLQPRTFLL	unknown
CSARDSRGQNTGELFF	YLQPRTFLL	unknown
CARGSLNTGELFF	YLQPRTFLL	unknown
CAIQDSNTGELFF	YLQPRTFLL	unknown
CASGEDLPQHF	YLQPRTFLL	unknown
CARGAANTGELFF	YLQPRTFLL	unknown
CASDRDRNTGELFF	YLQPRTFLL	unknown
CASSDIDSGELFF	YLQPRTFLL	unknown
CSVETDRNTVEAFF	YLQPRTFLL	unknown
CSVGELNTGELFF	YLQPRTFLL	unknown
CATSDTQKANTGELFF	YLQPRTFLL	unknown
CASRDLAGWNTGELFF	YLQPRTFLL	unknown
CASSQVSLVEQFF	YLQPRTFLL	unknown
CASSIGESQPQHF	YLQPRTFLL	unknown
CASSEVEGGNTGELFF	YLQPRTFLL	unknown
CASSTMVGGKGEKLFF	YLQPRTFLL	unknown
CATTELNTGELFF	YLQPRTFLL	unknown
CASRDRDSLNTGELFF	YLQPRTFLL	unknown
CASSTMVGGKGEKLFF	YLQPRTFLL	unknown
CANQDLNTGELFF	YLQPRTFLL	unknown
CSARDPGAFNTGELFF	YLQPRTFLL	unknown
CASSPEDEQYF	YLQPRTFLL	unknown
CASSELNGFEAFF	YLQPRTFLL	unknown
CASSDIAGGNTGELFF	YLQPRTFLL	unknown
CASSLPAGWEDTQYF	YLQPRTFLL	unknown
CSAREQDRSYGYTF	QYIKWPWYI	unknown
CASSFPASGLEVTQYF	QYIKWPWYI	unknown
CASSYNRGVWNEQFF	QYIKWPWYI	unknown
CASSFPASGLEVTQYF	QYIKWPWYI	unknown
CSFGPQGAKYEQYF	QYIKWPWYI	unknown
CASSLKAGGLGDTQYF	QYIKWPWYI	unknown
CASSFQGLGNGYTF	QYIKWPWYI	unknown
CASSTDFDRRGTQYF	QYIKWPWYI	unknown
CASSYAGAGEQFF	QYIKWPWYI	unknown
CASSYAGAGEQFF	QYIKWPWYI	unknown
CASSEGLAGPRELFF	QYIKWPWYI	unknown
CASRTGASNEQFF	QYIKWPWYI	unknown
CASSQELRERYNEQFF	QYIKWPWYI	unknown
CASSDGTSGRHMGDEQFF	QYIKWPWYI	unknown
CASSIVLSEKLFF	QYIKWPWYI	unknown
CASSPTTGFSTNEKLFF	QYIKWPWYI	unknown
CASSYAGAGEQFF	QYIKWPWYI	unknown
CSARDGGRAYEQYF	QYIKWPWYI	unknown
CASSWTGGSGNTIYF	QYIKWPWYI	unknown
CSARPTSGGRHYEQYF	QYIKWPWYI	unknown
CASSLQGARKLFF	QYIKWPWYI	unknown
CSARDQQGAHLEQYF	QYIKWPWYI	unknown
CASSGGSENTEAFF	QYIKWPWYI	unknown
CASSPAGGGSSYEQYF	QYIKWPWYI	unknown
CASSLAGTGFGHEQYF	QYIKWPWYI	unknown
CATSTEQGREQFF	QYIKWPWYI	unknown
CSARDQGGTGVLDTQYF	QYIKWPWYI	unknown
CASSQGLGGTDNSPLHF	QYIKWPWYI	unknown
CSARDPDGAYEQYF	QYIKWPWYI	unknown
CASSLGGGGLNTEAFF	QYIKWPWYI	unknown
CASSFYMGYEQYF	QYIKWPWYI	unknown
CASSFYMGYEQYF	QYIKWPWYI	unknown
CSARDQGQTYEQYF	QYIKWPWYI	unknown
CSARDLAGSGGADTQYF	QYIKWPWYI	unknown
CASSFVGAPEQYF	QYIKWPWYI	unknown
CASSIRAGGRRDEQFF	QYIKWPWYI	unknown
CSARDLAGSGGADTQYF	QYIKWPWYI	unknown
CSAPRQGWADTQYF	QYIKWPWYI	unknown
CASSLQQGITDTQYF	QYIKWPWYI	unknown
CASSTGQGVWEQFF	QYIKWPWYI	unknown
CSARDQAEAYEQYF	QYIKWPWYI	unknown
CASSLQQGITDTQYF	QYIKWPWYI	unknown
CASSTGQGVWEQFF	QYIKWPWYI	unknown
CASSLQQGGIDTQYF	QYIKWPWYI	unknown
CSARRAGSNTGELFF	QYIKWPWYI	unknown
CASSYSPREQYF	QYIKWPWYI	unknown
CASSLQQGITDTQYF	QYIKWPWYI	unknown
CASSPPEEFEQYF	QYIKWPWYI	unknown
CASSHLGGVGADTQYF	QYIKWPWYI	unknown
CSARNRDRAYEQYF	QYIKWPWYI	unknown
CASSISRPTTGGRTEAFF	QYIKWPWYI	unknown
CSARDSGKAYEQYF	QYIKWPWYI	unknown
CASRRPGRFTDTQYF	QYIKWPWYI	unknown
CSARDIRTSGSYEQYF	QYIKWPWYI	unknown
CASSLVGVGGTEAFF	QYIKWPWYI	unknown
CSARGTGAYEQYF	QYIKWPWYI	unknown
CASSFDGTGRNTQYF	QYIKWPWYI	unknown
CASSQGGGRGTDTQYF	QYIKWPWYI	unknown
CSARPTGSYEQYF	QYIKWPWYI	unknown
CASSMNAGVTEAFF	QYIKWPWYI	unknown
CASSSPGQGPYGYTF	QYIKWPWYI	unknown
CASSIAGGSGETQYF	QYIKWPWYI	unknown
CASSWTLISRGRLNYGYTF	QYIKWPWYI	unknown
CASSVAGQGYGEQYF	QYIKWPWYI	unknown
CSARGTGAYEQYF	QYIKWPWYI	unknown
CASSPPQGGSYEQYF	QYIKWPWYI	unknown
CASSLGGFGSPLHF	QYIKWPWYI	unknown
CASSTSGGGEQYF	QYIKWPWYI	unknown
CASSLGSYGSPLHF	QYIKWPWYI	unknown
CSVLTGAGVYTGELFF	QYIKWPWYI	unknown
CASSPMTGQEKDKNIQYF	SPRWYFYYL	unknown
CASSPITGAPEAKNIQYF	SPRWYFYYL	unknown
CASSSGTGQGGFYGYTF	SPRWYFYYL	unknown
CASSLFSSGQGNGYTF	SPRWYFYYL	unknown
CASSPLTGRSEEKETQYF	SPRWYFYYL	unknown
CASRPLTGGPLAKNIQYF	SPRWYFYYL	unknown
CSARDPGRNFYDEQFF	SPRWYFYYL	unknown
CASSLAGANEQFF	SPRWYFYYL	unknown
CASSSRTAPSDTQYF	SPRWYFYYL	unknown
CASSLAGGPLHEQFF	SPRWYFYYL	unknown
CASSQEWTGRTEAFF	SPRWYFYYL	unknown
CASSYYPSASGRADETQYF	SPRWYFYYL	unknown
CASSQDSGTGSKNTIYF	SPRWYFYYL	unknown
CASSPRDSPSDEQFF	SPRWYFYYL	unknown
CASSSMTGIGRYEQYF	SPRWYFYYL	unknown
CASSFLVGRAPEKETQYF	SPRWYFYYL	unknown
CASSLAGGWGTEAFF	SPRWYFYYL	unknown
CASSLAGLGYTF	SPRWYFYYL	unknown
CASSLFSGGAAMNTEAFF	SPRWYFYYL	unknown
CASSSLTGPSLAKNIQYF	SPRWYFYYL	unknown
CASSQVLAGSTDTQYF	SPRWYFYYL	unknown
CASSLAGGPATEQYF	SPRWYFYYL	unknown
CATSRLAGGYNEQFF	SPRWYFYYL	unknown
CASSEFPGPPGELFF	SPRWYFYYL	unknown
CASSLAGALEQYF	SPRWYFYYL	unknown
CASSTEDRVSYNEQFF	SPRWYFYYL	unknown
CASRHHLIGTGHTGELFF	SPRWYFYYL	unknown
CASSQDWTEVHEQFF	SPRWYFYYL	unknown
CSVDGGSTIYF	SPRWYFYYL	unknown
CSATYRGTPYEQYF	SPRWYFYYL	unknown
CASSLWNTGELFF	SPRWYFYYL	unknown
CASNLLTGGDADTQYF	SPRWYFYYL	unknown
CASSAIAGGRREQYF	SPRWYFYYL	unknown
CASSRAQSSYGYTF	SPRWYFYYL	unknown
CATQPRSSYNSPLHF	SPRWYFYYL	unknown
CASSRTGGSYNEQFF	SPRWYFYYL	unknown
CASRNLTGNIQYF	SPRWYFYYL	unknown
CATEPGQGLVGELFF	SPRWYFYYL	unknown
CATSEEVPNTEAFF	SPRWYFYYL	unknown
CASSLAGGGTQPQHF	SPRWYFYYL	unknown
CASSPLTGGPEEKGTQYF	SPRWYFYYL	unknown
CASSLAGVSSGANVLTF	SPRWYFYYL	unknown
CASSALTSAKRYEQFF	SPRWYFYYL	unknown
CASSRLTPGQGDYF	SPRWYFYYL	unknown
CASSAPVISGTYEQYF	SPRWYFYYL	unknown
CASSRLESLGNTIYF	SPRWYFYYL	unknown
CASSVEVQARSDTQYF	SPRWYFYYL	unknown
CASSPLAGGFEKKETQYF	SPRWYFYYL	unknown
CASRRDRVNTEAFF	SPRWYFYYL	unknown
CASSSLVGIQAGKETQYF	SPRWYFYYL	unknown
CASSPALGREQYF	SPRWYFYYL	unknown
CASSLAGAQGYTF	SPRWYFYYL	unknown
CASSLAGAQEQFF	SPRWYFYYL	unknown
CASSLGTPLNTEAFF	SPRWYFYYL	unknown
CASSLLPLGGQKDNEQFF	SPRWYFYYL	unknown
CATSDLTQDTQYF	SPRWYFYYL	unknown
CASRASGGFNEQFF	VYIGDPAQL	unknown
CASSKRTDSYEQYF	PTDNYITTY	unknown
CASSFRSNSYEQYF	PTDNYITTY	unknown
CASSLASNNYEQYF	PTDNYITTY	unknown
CASSLTGPETQYF	PTDNYITTY	unknown
CASSLTRAGELFF	PTDNYITTY	unknown
CASSLRSNSYEQYF	PTDNYITTY	unknown
CASSLTTDTQYF	PTDNYITTY	unknown
CASSLNSNSYEQYF	PTDNYITTY	unknown
CASSLYADSYEQYF	PTDNYITTY	unknown
CASSFFSNAYEQYF	PTDNYITTY	unknown
CASSHKSNSYEQYF	PTDNYITTY	unknown
CASSLTGGNYGYTF	PTDNYITTY	unknown
CASKTGGAAKNIQYF	VYIGDPAQL	unknown
CASSRPTEKNEQFF	DTDFVNEFY	unknown
CASSKSPGYEQFF	DTDFVNEFY	unknown
CASSSPQESNQPQHF	PTDNYITTY	unknown
CASSRRTDSHEQYF	PTDNYITTY	unknown
CASSSGQGAFTDTQYF	PTDNYITTY	unknown
CASSRDSFKETQYF	LLYDANYFL	unknown
CASSGPRGVGETQYF	LLYDANYFL	unknown
CASSLGNIEAFF	LLYDANYFL	unknown
CAISGGVEGGRTDTQYF	LLYDANYFL	unknown
CASSERLAGGPRESYEQYF	LLYDANYFL	unknown
CASSLDSSLGYGYTF	LLYDANYFL	unknown
CASSLGAGGTEAFF	LLYDANYFL	unknown
CASSLNGGTEAFF	LLYDANYFL	unknown
CASSLGQTEAFF	LLYDANYFL	unknown
CASSIGGTEAFF	LLYDANYFL	unknown
CASSYTNEQYF	ALSKGVHFV	unknown
CSASAGEGAEAFF	ALSKGVHFV	unknown
CASRLPQWGRTYSNQPQHF	LLYDANYFL	unknown
CASAFGQTSYGYTF	LLYDANYFL	unknown
CATSGALAGGRTDTQYF	LLYDANYFL	unknown
CASSPWTGTGYEQYF	FTSDYYQLY	unknown
CASSSFAGTGELFF	FTSDYYQLY	unknown
CASGEAAYEQYF	ALSKGVHFV	unknown
CASSPGGTATYEQYF	ALSKGVHFV	unknown
CASSLSGGGGTTNEQFF	LLYDANYFL	unknown
CASSTDREGITPQHF	ALSKGVHFV	unknown
CSADLGTGTDTQYF	ALSKGVHFV	unknown
CASSQVRKGGALGNIQYF	VYFLQSINF	unknown
CASSLAGDNYNEQFF	ALSKGVHFV	unknown
CASSQVQGVDLTGELFF	ALSKGVHFV	unknown
CASSLGSSEAFF	LLYDANYFL	unknown
CASSDQDRVHSGANVLTF	LLYDANYFL	unknown
CASPPLQGTEAFF	ALSKGVHFV	unknown
CASSLYEDRANWEQYF	LLYDANYFL	unknown
CASSLGGEGAFF	LLYDANYFL	unknown
CASSVGGSWTDTQYF	FTSDYYQLY	unknown
CASSVASGSSYEQYF	FTSDYYQLY	unknown
CASSWTGSTEAFF	LLYDANYFL	unknown
CASSLGGGTSGDTSTDTQYF	LLYDANYFL	unknown
CASSQDFSGGGTEAFF	LLYDANYFL	unknown
CASSSGVGQEAHEQYF	VLNDILSRL	unknown
CASSLLDSLEQYF	YLQPRTFLL	unknown
CSARTPMGQNTGELFF	YLQPRTFLL	unknown
CASSSDIIAFF	YLQPRTFLL	unknown
CASGDLNTGELFF	YLQPRTFLL	unknown
CARQDSNTGELFF	YLQPRTFLL	unknown
CAGQGLNTGELFF	YLQPRTFLL	unknown
CASGDGNTGELFF	YLQPRTFLL	unknown
CASSSGQGVDAFF	YLQPRTFLL	unknown
CASGFGQANNEKLFF	RLQSLQTYV	unknown
CAVEGVYGEAFF	YLQPRTFLL	unknown
CASSPDVEAFF	YLQPRTFLL	unknown
CSARDLAGMNTGELFF	YLQPRTFLL	unknown
CASSSEIEAFF	YLQPRTFLL	unknown
CAIQEANTGELFF	YLQPRTFLL	unknown
CAEQDLNTGELFF	YLQPRTFLL	unknown
CSARDAGGQNTGELFF	YLQPRTFLL	unknown
CSVSRDRNTGELFF	YLQPRTFLL	unknown
CASRGPGQMNTGELFF	YLQPRTFLL	unknown
CASSSDDMRNTGELFF	YLQPRTFLL	unknown
CADQDSNTGELFF	YLQPRTFLL	unknown
CATLGSNTGELFF	YLQPRTFLL	unknown
CASPSENTGELFF	YLQPRTFLL	unknown
CATSDLQRGNTGELFF	YLQPRTFLL	unknown
CSARDQASQNTGELFF	YLQPRTFLL	unknown
CSARDERALNTGELFF	YLQPRTFLL	unknown
CAIASQNTGELFF	YLQPRTFLL	unknown
CSARDHGATNTGELFF	YLQPRTFLL	unknown
CASAEMNTGELFF	YLQPRTFLL	unknown
CASMDLNTGELFF	YLQPRTFLL	unknown
CASSPDILAFF	YLQPRTFLL	unknown
CASSLAAGGSWNEQFF	FIAGLIAIV	unknown
CASNQGGGKFEAFF	FIAGLIAIV	unknown
CASSETGSSSYEQYF	QYIKWPWYI	unknown
CASSEGRGYEQFF	NYNYLYRLF	unknown
CASSVGQGYEQYF	NYNYLYRLF	unknown
CASSLQVNTEAFF	QYIKWPWYI	unknown
CASSEFTNYEQYF	NYNYLYRLF	unknown
CASSEGESNTGELFF	YLQPRTFLL	unknown
CASSSVSLGNEQFF	YLQPRTFLL	unknown
CASSADIEQYF	YLQPRTFLL	unknown
CSVDRDRNTGELFF	YLQPRTFLL	unknown
CAGSTSLTGELFF	YLQPRTFLL	unknown
CASSQDIYAFF	YLQPRTFLL	unknown
CASSPDILHTF	YLQPRTFLL	unknown
CANGSPNTGELFF	YLQPRTFLL	unknown
CASSPPSGGNTGELFF	YLQPRTFLL	unknown
CASSDDLGGNTGELFF	YLQPRTFLL	unknown
CASSYRGQPQHF	LTDEMIAQY	unknown
CASSTGGGELFF	LTDEMIAQY	unknown
CSAREIIAYEQYF	FIAGLIAIV	unknown
CASSQDRDYEQYF	FIAGLIAIV	unknown
CASSAGTGDSYEQYF	FIAGLIAIV	unknown
CASTEDQSGNTQYF	VLNDILSRL	unknown
CASLGDPNTGELFF	YLQPRTFLL	unknown
CASSILAGGNTGELFF	YLQPRTFLL	unknown
CASSPPGHGNTGELFF	YLQPRTFLL	unknown
CSARDVVSGGHYEQYF	QYIKWPWYI	unknown
CSARDIGTGAHYEQYF	QYIKWPWYI	unknown
CASSETQGYEQFF	NYNYLYRLF	unknown
CASSEWRGYEQYF	NYNYLYRLF	unknown
CASSQVAGYEQYF	NYNYLYRLF	unknown
CASSEGQGPYEQYF	NYNYLYRLF	unknown
CATSESGGYEQYF	NYNYLYRLF	unknown
CASSEWQGGYEQYF	NYNYLYRLF	unknown
CASSPDPQETQYF	NYNYLYRLF	unknown
CASSSEESSSIDTQYF	QYIKWPWYI	unknown
CASGLVQGYEQYF	NYNYLYRLF	unknown
CASSHTGGYEQFF	NYNYLYRLF	unknown
CASSLTSGYEQYF	NYNYLYRLF	unknown
CASQDINTGELFF	YLQPRTFLL	unknown
CATTDLDSGELFF	YLQPRTFLL	unknown
CASFQDQNTGELFF	YLQPRTFLL	unknown
CAWLRDMNTGELFF	YLQPRTFLL	unknown
CATQTLNTGELFF	YLQPRTFLL	unknown
CASHSDRNTGELFF	YLQPRTFLL	unknown
CASEDLNTGELFF	YLQPRTFLL	unknown
CASSPEDIQYF	YLQPRTFLL	unknown
CAEGERNTGELFF	YLQPRTFLL	unknown
CSAQWDRNTGELFF	YLQPRTFLL	unknown
CASTLRNQETQYF	RLQSLQTYV	unknown
CASSVSPNEQFF	YLQPRTFLL	unknown
CASGHPNDLKAFF	YLQPRTFLL	unknown
CASSPRGPSTDTQYF	YLQPRTFLL	unknown
CASSSATFFEQNYGYTF	YLQPRTFLL	unknown
CATGGDHNTGELFF	YLQPRTFLL	unknown
CASRDRGNYYGYTF	YLQPRTFLL	unknown
CASSWDKFYEQYF	LTDEMIAQY	unknown
CSVTRDSNTGELFF	YLQPRTFLL	unknown
CSARDQQGQNTGELFF	YLQPRTFLL	unknown
CASSEIAGGNTGELFF	YLQPRTFLL	unknown
CASTELDTGELFF	YLQPRTFLL	unknown
CASSPIKDTRQEYTGELFF	FTSDYYQLY	unknown
CASSFSSNSYEQYF	PTDNYITTY	unknown
CASSQDRSGGATDTQYF	VYFLQSINF	unknown
CASSVAGGLYEQFF	VYIGDPAQL	unknown
CASSLGATNSPLHF	CVMYASAVV	unknown
CASSFGTSGEQFF	KPASRELKV	unknown
CASSPGLIATNTGELFF	FIASFRLFA	unknown
CSARALAGEYLFF	PTDQSFYIV	unknown
CASSSQGAISNQPQHF	GLIAIVMVT	unknown
CASSQDGWGERVPQHF	GLFKDCSKV	unknown
CASSEVYSNQPQHF	NVFAFPFTI	unknown
CATSRGYRGEETQYF	YLDSTDVTI	unknown
CASSLVSLQETQYF	ALWEIQQVV	unknown
CASSMSGLATEAFF	RVAGDSGFAAY	unknown
CASSLGATGDEQYF	LSPRWYFYY	unknown
CASTPGAGEGYEQYF	TLVFLFVAA	unknown
CASSTGQVETQYF	LIDFYLCFL	unknown
CAWRRITSTDTQYF	AIILASFSA	unknown
CASSLAEEEYEQYF	KLIEYTDFA	unknown
CASSVVGDTDTQYF	MPASWVMRI	unknown
CASGREAPWNEQFF	SLLSVLLSM	unknown
CSVEQTDTEAFF	VIYMGTLSY	unknown
CASSLADDEQFF	ALLSDLQDL	unknown
CSARSGLAGVADTQYF	LDRLNQLES	unknown
CATSDSGPSYNEQFF	RTIKGTYHW	unknown
CASSIRTSGGQETQYF	NTFSSTFNV	unknown
CASSLPPPSASGSKSNEQFF	RSRNSSRNL	unknown
CSARASGYSYEQYF	NPTIQKNVL	unknown
CASSLGREEGGELFF	TLLFLMSFT	unknown
CASRRAADPYNEQFF	LMNVLTLFY	unknown
CASSSPTDTYEQYV	TVLSFCAFA	unknown
CAISELNQPQHF	YTNDKACPL	unknown
CASRPAGGWGNEQFF	YLNSTNVTI	unknown
CASSPNMFYGYTF	LYALVYFLQ	unknown
CSVGVSVPYNEQFF	KLVSSFLEM	unknown
CASSLQEGGTDTQYF	FSDVTWFHA	unknown
CASSEYTGAGTGELFF	YTMADLVYA	unknown
CASSLDLMGNQPQHF	FIDTKRGVY	unknown
CAWGGGWETQYF	IQPGQTFSV	unknown
CASSPTTGAATEAFF	KPLPEVKIL	unknown
CSARDLAGGTLNEQFF	ILLLDQALV	unknown
CSAVFRGARNIQYF	FGDDTVIEV	unknown
CASSIWGHTTDTQYF	ALVYFLQSI	unknown
CASSSSGQGAGEQYF	HTDLMAAYV	unknown
CASSYPPRTPEYEQYF	VLLSVLQQL	unknown
CASSDRRGTDTQYF	VINGDRWFL	unknown
CATGRGGETGELFF	TLGVLVPHV	unknown
CATSRDSGLAGYTF	FPQSAPHGVVF	unknown
CASSRNQGREAAFF	KQLSSNFGA	unknown
CASSRLGTAGYTF	LLWPVTLAC	unknown
CASSLSGQRGNQPQHF	LLLDRLNQL	unknown
CASSLGSSGRPGGDTQYF	NTLQCIMLV	unknown
CASTTWGGTDTQYF	DKDPNFKDQ	unknown
CASSFSGDRIDEQFF	FLEGETLPT	unknown
CAISEMASGLSGELFF	PTDNYITTY	unknown
CASSLGGDYGYTF	LPDDFMGCV	unknown
CASSEAAGGRVAYEQYF	YADVFHLYL	unknown
CASSEVGVAVSTDTQYF	KQIYKTPPI	unknown
CASSKGQSTDTQYF	FIDIKRGVY	unknown
CASSQDLEAFF	FTSDYYQLY	unknown
CASSPDTHQPQHF	FPDLNGDVV	unknown
CASCQYGSNQPQHF	ILPDPSKPS	unknown
CSAPGLAGELFF	MEVTPSGTWL	unknown
CASSGAGGDTGELFF	VLAWLYAAV	unknown
CSAPRLAGTDTQYF	IPIQASLSF	unknown
CSVDEQVYGYTF	YTPSKLIEY	unknown
CASSPTRGGLLAGSTDTQYF	LLFNKVTLA	unknown
CAWSRGVAGTQETQYF	FPLCANGQV	unknown
CASSPTGGSMNEQFF	IKLDDKDPN	unknown
CASSQDKDIMNTEAFF	HLLLVAAGL	unknown
CASSSGPKGTQYF	SPRWYFYYL	unknown
CASSLIGRGEYGYTF	SVFNICQAV	unknown
CASSLGAQGYNEQFF	YLAVFDKNL	unknown
CASSYGPGTQYF	SLTYSTAAL	unknown
CASSEGQRLLDF	QVVSDIDYV	unknown
CASSLVHQPQHF	YYRYNLPTM	unknown
CASSYSIPGHPTMYF	ALWEIQQVV	unknown
CASSDPGTGINF	LTYHGAIKL	unknown
CSVVIYVARAAQSSYNEQFF	FLPFFSNVT	unknown
CSAMTTLSYNEQFF	LPKEITVAT	unknown
CASSVGTSDSYEQYF	CVMYASAVV	unknown
CATSRDRGSYEQYF	NVLTLVYKV	unknown
CASSPIETGGPPQHF	VMVELVAEL	unknown
CASGMDRAVNQPQHF	FPFTSFGPL	unknown
CASRVFTGSYNEQFF	LLLTILTSL	unknown
CATGQGHQPQHF	SIWNLDYII	unknown
CASSLAGTGNTEAFF	LTYHGAIKL	unknown
CASLGGTQPQHF	YTNSFTRGV	unknown
CASSPKWISGSRNEQFF	YTACSHAAV	unknown
CASSHNRGTGELFF	NYNYLYRLF	unknown
CASSGGLADTQYF	MPNMLRIMA	unknown
CASSSANTGGRETQYF	FMIDVQQWG	unknown
CASSQTGGRETQYF	GDAALALLL	unknown
CASRGGGSGANVLTF	WMVMFTPLV	unknown
CASSRSGTADTQYF	NYNYLYRLF	unknown
CASSQQTGWETQYF	TVYSHLLLV	unknown
CASSGRAYNEQFF	IVAGGIVAI	unknown
CASSLDAGTRNEQFF	ILTSLLVLV	unknown
CASSLSHANYGYTF	TPINLVRDL	unknown
CASSQDSDSGNTIYF	VLWAHGFEL	unknown
CASSFTGRTGELFF	RLITGRLQSL	unknown
CASSRTSGSRTDTQYF	NLHPDSATL	unknown
CSASGSNTGELFF	FLPGVYSVI	unknown
CSARQVDNQPQHF	TALALLLLD	unknown
CSAHKTGGLETQYF	NLDYIINLI	unknown
CASSYPVSYGYTF	ISQWLTNIF	unknown
CASSLQGARREAFF	VTDVTQLYL	unknown
CASSPGGGVGYTF	KPAPRELKV	unknown
CSAVGGRTYGYTF	EWSMATYYL	unknown
CASSKDRPNFYEQYF	MQVESDDYI	unknown
CASRQAAGNTIYF	LTDEMIAQY	unknown
CSAREDRVKNIQYF	AMMFTSDLA	unknown
CATRPGTSNTDTQYF	VPGLPGTIL	unknown
CASSLWHNYGYTF	TMCDIRQLL	unknown
CASSRIEYGYTF	YQDVDCTEV	unknown
CASSLDGGGWADTQYF	FLPGVYSVI	unknown
CASSRRAAGAYNEQFF	LPDDFMGCV	unknown
CSVDRGVGQPQHF	SLINTLNDL	unknown
CASSFLATLNSGNTIYF	FLNGSCGSV	unknown
CSAPPPLGNTEAFF	YLRPRTFLL	unknown
CASSPQASGRDEQFF	ALVYFLQSI	unknown
CASSLQSFSGNTIYF	LNKHIDAYK	unknown
CSALGTGNQPQHF	FPDLNGDVV	unknown
CASNTGTSGRVEQFF	KLIEYTDFA	unknown
CASSELGQGARGQETQYF	STQWSLFFF	unknown
CASSAAGGLGETQYF	IPARARVEC	unknown
CASSLGGQGGEKLFF	ALLADKFPV	unknown
CASSFQRLGTEAFF	YPLECIKDL	unknown
CASSLASGAIYF	ALYYPSARI	unknown
CASSFSGRGTRNEQFF	QLLFVVEVV	unknown
CASRYQGPNQPQHF	QLEMELTPV	unknown
CASSLGLTSGVTDTQYF	KITEHSWNA	unknown
CSARDQGYVNYGYTF	YVFHLYLQY	unknown
CASSFQGANEKLFF	IPIQASLSF	unknown
CASSPPGLAGNEQYF	RYRIGNYKL	unknown
CASSSAGGSSGNTIYF	LLDRLNQLE	unknown
CASSSPRVAVYNEQFF	APLLSAGIF	unknown
CASSLGTGRETQYF	FLALCADSI	unknown
CASRFGWDTGELFF	CLAYYFMRF	unknown
CSARPLRSGSYNEQFF	IMLCCMTSC	unknown
CASNSPTSRNEQFF	LPPANTNSF	unknown
CSARGGLGQRDRQPQHF	FLKKDAPYI	unknown
CASSPQSSYNEQFF	MASGGGETA	unknown
CASSEWNRRRSYEQYF	FSDVTWFHA	unknown
CASSLTGLAGGGYNEQFF	MLDMYSVML	unknown
CASSSTGQETQYF	SLSSTASAL	unknown
CASSRRTGKVNTDGYTF	LLFLMSFTV	unknown
CASSSGIGETQYF	VMVELVAEL	unknown
CASSDASNTEAFF	NYNYLYRLF	unknown
CSARNPTGELFF	GVYDYLVST	unknown
CSAQRQGGSQPQHF	FLLNKEMYL	unknown
CASSSPGLAGGEEQYF	LSDRVVFVL	unknown
CASSQEPVSYGYTF	FLTENLLLY	unknown
CASVTSGTGLNIQYF	TTEELPDEF	unknown
CASSLRGGSDSYEQYF	LPPANTNSF	unknown
CASSPRRDQPQHF	FFSYFAVHF	unknown
CASSRDIRGSYEQYF	NVLTLVYKV	unknown
CASSEQGANYEQYF	LFFSDVTWF	unknown
CASSPLAGGQTDTQYF	KLASHMYCS	unknown
CASSSAGGEAEAFF	VLQVRDVLV	unknown
CASSMGPRAEYGYTF	YADVFHLYL	unknown
CASSLDSSNEKLFF	ALNTPKDHI	unknown
CSVEWAGPNYGYTF	DKDPNFKDQ	unknown
CASSSGTATGELFF	TYHGAIKLD	unknown
CATEQRGQGYTF	VMVELVAEL	unknown
CSAGGGSGANVLTF	SMMILSDDA	unknown
CASSFSLASQYF	ELYHYQECV	unknown
CASKGTFSYEQYF	LNKHIDAYK	unknown
CASSQQGFYGYTF	SVLLFLAFV	unknown
CASSPIDTTDNSPLHF	QVVSDIDYV	unknown
CASTRGQDQFF	KLSYGIATV	unknown
CASVQGQGALNEQFF	KTFPPTEPK	unknown
CASRAGSSGNTIYF	VLCNSQTSL	unknown
CASRGGAYEQYF	TTLNDFNLV	unknown
CASSSIPLGEQFF	ILGLPTQTV	unknown
CASSSNSGSREQYF	TQMNLKYAI	unknown
CASGSGQGETGELFF	YFTSDYYQL	unknown
CASSPGLAGGHNEQFF	LLWPVTLAC	unknown
CASSTPRGLNTEAFF	IVDTVSALV	unknown
CSAREDGNTEAFF	QLCTQHQPY	unknown
CASSPGLAGLYEQYF	NTFSSTFNV	unknown
CASQGTSYEQYF	TGAIKLDDK	unknown
CASSGGLADYEQYF	ALLAVFQSA	unknown
CASSLVQTNTEAFF	KQLIKVTLV	unknown
CSGRQGRLGQPQHF	VINGDRWFL	unknown
CAISETSGNNEQFF	LPSYAALAT	unknown
CASSLDGRGTDTQYF	KSVDITFEL	unknown
CASSFRGGSYNEQFF	VINGDRWFL	unknown
CAISDSTPGNSPLHF	TVYEKLKPV	unknown
CASSSSSPGDTQYF	KWPWYIWLG	unknown
CASSLRSQPQHF	MLNPNYEDL	unknown
CASSDKVPRDRGDYGYTF	LQNNELSPV	unknown
CASSLWDSPSTDTQYF	KAYDVTQAF	unknown
CAIRPDRADTQYF	VTDNTFTLK	unknown
CASSQDPSEGDEQFF	VTDNTFTLK	unknown
CASSSLGGTGRYEQYF	TPRDLGACI	unknown
CASSPLDDRAYEQYF	YYQLYSTQL	unknown
CASSARTGGGTDTQYF	NLLKDCPAV	unknown
CASARRGRDEQYF	KDNVILLNK	unknown
CASSPPSGSNEQFF	GLTVLPPLL	unknown
CARQGESSYEQYF	YMPYFFTLL	unknown
CASTPAGRGGYTF	IMMNVAKYT	unknown
CASSLEDSGDQYF	KSVNITFEL	unknown
CASSDTGSVRAGELFF	CTDDNALAY	unknown
CASSLRGAAEQFF	LQAGNATEV	unknown
CASSHPRQGADTEAFF	RTAPHGHVV	unknown
CSASPSVTNEQYF	TLSEQLDFI	unknown
CASSSEFQPGLSPYEQYF	IFFITGNTL	unknown
CAWSVLLLAGGKAGELFF	FLRDGWEIV	unknown
CASSTGRGGTYEQYF	LMNVLTLFY	unknown
CASSRSGTSDYEQYF	YMPYIFTLL	unknown
CASGGTGTNTGELFF	RLDKVEAEV	unknown
CASSLLAGGPGTQYF	RPQGLSNNT	unknown
CASKQGMNTEAFF	VLWAHGFEL	unknown
CSARDSGKETQYF	NMLRIMASL	unknown
CASSLGDVQYF	STDVTIATY	unknown
CASSLGTSGVDTQYF	SMMILSDDA	unknown
CASSLEARPNQPQHF	FAMQMAYRF	unknown
CASSFGDTYNSPLHF	KMVSLLSVL	unknown
CATARGPDSGANVLTF	MIDVQQWGF	unknown
CSVEGLLSSYNEQFF	WICLLQFAY	unknown
CASSLLGGPAWYNEQFF	VYIGDPAQL	unknown
CASDPTNTGELFF	TVYSHLLLV	unknown
CASSPDRNYGYTF	SQLGGLHLL	unknown
CASLNRANTEAFF	VLLFLAFVV	unknown
CASAHRGTLVVYGYTF	TSAMQTMLF	unknown
CSAWDRNTEAFF	YVYSRVKNL	unknown
CASSLALGGEAVQSYEQYF	QWNLVIGFL	unknown
CASSSSRAGRSSYEQYF	HLRMAGHSL	unknown
CASSLGVTSGYNEQFF	ALLAVFQSA	unknown
CASSLRRVDGYGYTF	ALYYPSARI	unknown
CAISPGQGRYGYTF	FFSYFAVHF	unknown
CASRSGGFYSNQPQHF	VYSTGSNVF	unknown
CASSPSRQENYGYTF	LITGRLQSL	unknown
CATSDKVGEQYF	FAFACPDGV	unknown
CASTPSGVETQYF	VTDNTFTLK	unknown
CASSADSFDTGELFF	SLINTLNDL	unknown
CSVDISGQGHTGELFF	QMAPISAMV	unknown
CASSRFGADTQYF	TLVFLFVAA	unknown
CASSLGQGEYYEQYF	TLSEQLDFI	unknown
CAISEDRYQETQYF	TTEELPDEF	unknown
CASSDLQGEETQYF	KLPDDFMGC	unknown
CASSQGLAGDKNIQYF	QYIKWPWYI	unknown
CASSLADQETQYF	CLTPVYSFL	unknown
CASSRDTTNEKLFF	FVDGVPFVV	unknown
CASSYSGAAKNIQYF	FKDNVILLN	unknown
CANRGTGVYNEQFF	TLNDFNLVA	unknown
CASSNGLAGEYEQYF	QLCTQHQPY	unknown
CASSDLDRGNNQPQHF	MSAFAMMFV	unknown
CASGGLRTDTQYF	QADVEWKFY	unknown
CASSHVDKYEQYF	YYQLYSTQL	unknown
CASSSEDRGWDEQFF	TQWSLFFFL	unknown
CASSSRGAGATDTQYF	NVFAFPFTI	unknown
CASRRSGTASDTQYF	NMMVTNNTF	unknown
CASSLANKQGSNSPLHF	ATSRMLSYY	unknown
CASSLQGGGAINEQFF	CLGSLIYST	unknown
CASSEGTALTGELFF	LTGHMLDMY	unknown
CSARGPSGRGNEQFF	AMDEFIERY	unknown
CASSEETRIFSGNYGYTF	YLEGSVRVV	unknown
CASSLAETSKGYTF	HLMSFPQSA	unknown
CASSPKAGSYEQYF	IPTNFTISV	unknown
CASSLQGIEQFF	YFLQSINFV	unknown
CASSGRGPDTQYF	VMVELVAEL	unknown
CASRASGNNEQFF	LDDKDPQFK	unknown
CASSRDRAEKLFF	FLAHIQWMV	unknown
CASSQELAEDTQYF	LYALVYFLH	unknown
CASTRGPNSYNEQFF	KPVPEVKIL	unknown
CASSQQGQGAGEQFF	VTWFHAIHV	unknown
CASSPSMNRAADEQFF	KVYPIILRL	unknown
CASSLEGTTEAFF	YASAVVLLI	unknown
CASSIRGVEETQYF	NYMPYFFTL	unknown
CASSEGTTSGNTIYF	LVLSVNPYV	unknown
CASSLAGLNTDTQYF	YYTSNPTTF	unknown
CASSLGRGRSTNEKLFF	LLFLVLIML	unknown
CATRQAGEKLFF	DQVILLNKH	unknown
CASSRVRADTQYF	FPDLNGDVV	unknown
CASSYPRTGRNSYEQYF	YFLQSINFV	unknown
CASSTLTGDRQYF	KLVNKFLAL	unknown
CASSIATQAIQPQHF	KDNVILLNK	unknown
CASSLGTGSIGEQYF	SVAALTNNV	unknown
CAFKLAGVRAGANVLTF	APLLSAGIF	unknown
CASSDGTSGGETQYF	SPNLAWPLI	unknown
CASTLSSGQYSPLHF	FLGIITTVA	unknown
CASSVHDGRLNDEKLFF	KAYDVTQAF	unknown
CASSGGTHNEQFF	FVMMSAPPA	unknown
CASRSPGEETQYF	IPTITQMNL	unknown
CASSYGGGIINEQFF	RLNEVAKNL	unknown
CASSYTTGEDTEAFF	TLNDLNETL	unknown
CSVGEQDDYEQYF	AMDEFIEQY	unknown
CASSSKREGRLADTQYF	VLSTFISAA	unknown
CATSRDRTADYTF	NVLTLVYKV	unknown
CASSTAGGTYNEQFF	LQAENVTGL	unknown
CASSYSPGISNYGYTF	FVFLVLLPL	unknown
CASSEVLLENSNQPQHF	ALQIPFAMQM	unknown
CATSDLSVPETQYF	FLEYHDVRV	unknown
CAWSLSRGQETQYF	RPDTRYVLM	unknown
CASSSSMKGLSSYNEQFF	APYIVGDVV	unknown
CASLVAAGYEQYF	YLEGSVRVV	unknown
CASSKPGRREQFF	TTEELPDEF	unknown
CASSSKREAYRGSYNEQFF	FAFACPDGV	unknown
CASSFAGWRTGELFF	ALWEIQQVV	unknown
CSATSGSSYNEQFF	ALNLGETFV	unknown
CSASPGQGYGYTF	FAFACPDGV	unknown
CSAREGIGEKLFF	ALLADKFPV	unknown
CATRDTVYTEAFF	KLDDKDPNF	unknown
CASSLASGQGYNSPLHF	SVAALTNNV	unknown
CASSFQNNYGYTF	HSYFTSDYY	unknown
CAWSFSGGNTEAFF	FAFACPDGV	unknown
CASSPIWGREQYF	GLIAIVMVT	unknown
CSARSTGVHEQFF	IIWFLLLSV	unknown
CSARDRDRGSYGDSPLHF	FPLCANGQV	unknown
CASSLGWRQYQETQYF	VYAWNRKRI	unknown
CASRPDLGELFF	IFNGECPNF	unknown
CSAAPPTNTGELFF	MIDVQQWGF	unknown
CASIKDSLESPFEAFF	EIDPKLDNY	unknown
CASRPGQLTYNEQFF	ALYYPSARI	unknown
CASSPQEGSTDTQYF	NVFAFPFTI	unknown
CASSIIISGANVLTF	FSAVGDICY	unknown
CSASRGMGEGGSPLHF	AEVQIDRLI	unknown
CSARDGVKESGNTIYF	LSFKELLVY	unknown
CASRRTGTSGYEQYF	QLLFVVEVV	unknown
CASSHVSGLNEKLFF	NLDESLIDL	unknown
CSARDSSGWSSYNEQFF	IPIQASLPF	unknown
CSARVLGIEQFF	MQLFFSYFA	unknown
CASRQAGETQYF	LMNVLTLVY	unknown
CSVGGGNTDTQYF	IFLWLLWPV	unknown
CSARAGGSNTEAFF	FPNITNLCP	unknown
CATSGIAGETQYF	YQVNGYPNM	unknown
CASSWGAGARNTEAFF	MCDVRQLLF	unknown
CASSDPAWGGRIETEAFF	YFTSDYYQL	unknown
CASSLGGQDVYGYTF	VQMAPISAM	unknown
CASSLGEGRAETQYF	VLCNSQTSL	unknown
CASSQTIGTGPRNEQFF	YTDFSSEII	unknown
CASSDGGGTDTQYF	TLATHGLAAV	unknown
CASSTPDEQETQYF	PTDNYITTY	unknown
CASRAGGADTQYF	NQKLIANQF	unknown
CASSFTGELFF	RLNQLESKM	unknown
CSARAVRGGFRETQYF	EIDPKLDNY	unknown
CASRGQGEEKLFF	TYHWLLLTI	unknown
CASSWGGGEGDTQYF	LQNNELSPV	unknown
CASSERRGLTEAFF	APLLSAGIF	unknown
CSATIRDRDYGYTF	LPPVYTNSF	unknown
CASSSGTSGGTGELFF	NLIDSYFVV	unknown
CASRLREGLEQYF	FLPFFSDVT	unknown
CAWSVRGANVLTF	LPSYAAFAT	unknown
CASSPKPQGTEAFF	APLLSAGIF	unknown
CASSSRGLAGHTDTQYF	CFAYYFMRF	unknown
CASSKGSYQETQYF	PTDSYITTY	unknown
CASSEGNPGFGSGNTIYF	LLDDFVEII	unknown
CAISEGAYPRTGELFF	LPSYAAFAT	unknown
CASSLLNEKLFF	IITTDNTFV	unknown
CASSPGGQPNEKLFF	TLGVLVPHV	unknown
CASSLVRSSYEQYF	LPDDFMGCV	unknown
CASSFRDGTYEQYF	QVVSDIDYV	unknown
CASSYSGLINTGELFF	LPKEITVAT	unknown
CASTDRGSGNTIYF	IPLTTAAKL	unknown
CATRAGGNEKLFF	ALNNIINNA	unknown
CASSYDPPNFKAFF	FIDTKRGVY	unknown
CASSLGRLAVTDTQYF	GDAALALLL	unknown
CASSQHSMDRRSGNTIYF	TWLTYTGAI	unknown
CASSITGNYGYTF	STSAFVETV	unknown
CASSGGAAVSGANVLTF	RLNQLESKV	unknown
CASSLGSGLGNQPQHF	RLCAYCCNI	unknown
CASSPRTSGRVSSYEQYF	KLNVGDYFV	unknown
CATSRELFF	LLLDDFVEI	unknown
CASSQVYSYEQYF	WLIVGVALL	unknown
CSARVAGLDPEQFF	TLATHGLAAV	unknown
CASNVGSLNSPLHF	SLPGVFCGV	unknown
CASRGTIRFGELFF	AMDEFIERY	unknown
CASSRPGQGNQETQYF	RLVDPQIQL	unknown
CAWVEFSGANVLTF	APTKVTFGV	unknown
CATSDPWTQGVEETQYF	MFLARGIVF	unknown
CASSAKKTGGVSNNEQFF	WLTNIFGTV	unknown
CASSFQTSGPQETQYF	TLIVNSVLL	unknown
CASLLAGANEQYF	TCDGTTFIY	unknown
CASSLSDRSYGYTF	FVDGVPFVV	unknown
CSAPRLAGDSGNNEQFF	RLVDPQIQL	unknown
CSVDEGLSYGYTF	GLNDNLLEI	unknown
CASNPGLVNTEAFF	TYHWLLLTI	unknown
CASSQDLPGLDLNEQFF	YLDAYNMMI	unknown
CASSYSSGTRDGYTF	FSNVTWFHA	unknown
CSAPRTGTGTFSGNQPQHF	ALLADKFPV	unknown
CASSLNGYTF	YVDNSSLTI	unknown
CASSSPKQGDGYTF	FITESKPSV	unknown
CASSVVGQPGQETQYF	NSTRFASVY	unknown
CSVRVGTSRTYYNEQFF	ELYHYQECV	unknown
CASSHVTRTSGKVTQYF	WMESEFRVY	unknown
CATGSTGYNEQFF	TVYSHLLLV	unknown
CASSLRGRNTEAFF	VLYENQKLI	unknown
CASSDHAPTYSNQPQHF	YTMADLVYA	unknown
CASSFGGGEQPQHF	LLDDFVEII	unknown
CASSSANTGELFF	DYTEISFML	unknown
CASSGGESLETQYF	YLNTLTLAV	unknown
CASSQGSGAPRAYEQYF	WPWYIWLGF	unknown
CASSPQGPETQYF	TPHTVLQAV	unknown
CASLPEPRVRETQYF	NVFAFPFTI	unknown
CASSQAGTSGSFGETQYF	RFLYIIKLI	unknown
CASRKAGQNYEQYF	IPIQASLPF	unknown
CASRNEYQGSYNEQFF	YVDNSSLTI	unknown
CATRGQDQETQYF	LPPVYTNSF	unknown
CASSGGTGGYQETQYF	FLPFFSNVT	unknown
CSARKGGTGLAYNSPLHF	LSDRVVFVL	unknown
CAWSVAVKTQYF	NVILLNKHI	unknown
CASSQTGVRFDEQFF	SLPGVFCGV	unknown
CASKVAGTDEETQYF	PQFKDNVIL	unknown
CASSKGPGKDTEAFF	ISDYDYYRY	unknown
CSARNTPYEQYF	AVASKILGL	unknown
CAWSPGANVLTF	EWSMATYYL	unknown
CASSSGTAGTGELFF	YANRNRFLY	unknown
CASSKRPGDEQYV	LTYHGAIKL	unknown
CASSLAGGRTDTQYF	SMWSFNPET	unknown
CASTFSRPTVGEKLFF	WLLWPVTLA	unknown
CASSEVTGATNEKLFF	RARLVSPKL	unknown
CASSPNRGPYNEQFF	FVMMSAPPA	unknown
CATSDLREFGEQFF	LLDDFVEII	unknown
CASSAPNSPLHF	SVAALTNNV	unknown
CASSLGLAGESYEQYF	VLNDILSRL	unknown
CASTLPGQSSYNEQFF	DYTEISFML	unknown
CASSASGTGQNYGYTF	FKDNVILLN	unknown
CASSRGQEEKLFF	LTNDDTSRY	unknown
CASGAQGWYEQYF	MPLSAPTLL	unknown
CASSRRDLSYEQYF	YANRNRFLY	unknown
CASSRTGSDQPQHF	LDRLNQLES	unknown
CSARLRSFYEQYF	AIMTRCLAV	unknown
CSVGQGEGQPQHF	LLDRLNQLE	unknown
CASKSGRRYNSPLHF	GLMWLSYFV	unknown
CASTELAGNTIYF	FLHVTYVPA	unknown
CASGERFNQPQHF	SIVAYTMSL	unknown
CASSSLAGAPDTQYF	VFLVLWPLV	unknown
CASRGDRGSNQPQHF	FTISVTTEI	unknown
CSAHRDNHNEQFF	YIDIGNYTV	unknown
CASSLAFGGRANEQFF	FSDVTWFHA	unknown
CSAWGTSSYEQYF	ITNFKSVLY	unknown
CSARDGGYGYTF	LQAGNATEV	unknown
CASSVLGGTSTDTQYF	FTPLVPFWI	unknown
CSVRRGETQYF	RTIKVFTTV	unknown
CASSLLGEETQYF	EWSMATYYL	unknown
CASNPDPGGQETQYF	ILAYCNKTV	unknown
CASSLVRGQGYEQYF	APRITFGGL	unknown
CASSFGQTSYNEQFF	IIFWFSLEL	unknown
CASSSQGNEKLFF	RLNQLESKV	unknown
CASRLTGGTEAFF	FIASFRLFA	unknown
CASSEARTGEEKLFF	AVASKILGL	unknown
CATSDRRRDRGIDEQFF	YTNDKACPL	unknown
CASSLTTGGDEAFF	ILTSLLVLV	unknown
CASSIGVREAFF	LDRLNQLES	unknown
CASSLSDDTDTQYF	YVDDSSLTI	unknown
CASSSSHAETQYF	SLLVLVQST	unknown
CASSEDGTYGYTF	ELTSMKYFV	unknown
CASVSGSLNTEAFF	HLRMAGHSL	unknown
CASSLDPLGPQHF	GLVEVEKGV	unknown
CASSTRQLRNEKLFF	YTVSCLPFT	unknown
CASKLTAWGGELFF	DLFMRIFTI	unknown
CASSERRDSYEQYF	FLAFVVFLL	unknown
CASSQAVESSYNEQFF	LLFLMSFTV	unknown
CASSLGNHYEQYF	FVLAAVYRI	unknown
CASSQSPGAQETQYF	LLLDRLNQL	unknown
CSAWTGTNEKLFF	ILAYCNKTV	unknown
CASSLDRASYEQYF	KISEMHPAL	unknown
CASSSTGDSNQPQHF	KPLPEVKIL	unknown
CASSFGTNNYGYTF	HLLLVAAGL	unknown
CASSLFRGNTYEQYF	MSAFAMMFV	unknown
CAIRANPSDTEAFF	NPTIQKNVL	unknown
CSAPHDYGYTF	NPANNASIV	unknown
CASSIADSPLHF	NSSTCMMCY	unknown
CATPRQNTGELFF	VLLAPLLSA	unknown
CASSYSAYGYTF	LLFLMSFTV	unknown
CASSRDRGRTEAFF	ATRGATVVI	unknown
CASSPGYNEQFF	WPLVSSQCV	unknown
CASSFDRASGYTF	GLIAIVMVT	unknown
CASIGTAEKAFF	FTSDYYQLY	unknown
CATSPPGGTGTGELFF	LQLGFSTGV	unknown
CASSVGERGTQYF	SLLVLVQST	unknown
CASTKNTGELFF	NLLKDCPAV	unknown
CASRGTREESNTGELFF	LPSYAAFAT	unknown
CASSLVPAEDTQYF	NLDAVPTGY	unknown
CSARDEGASRYGYTF	FMIDVQQWG	unknown
CASTLRDSTYNEQFF	NLHPDSATL	unknown
CASSLSEIGGEQYF	CFAYYFMRF	unknown
CASSVNRDDTQYF	NSAIGKIQY	unknown
CASNRLADTGELFF	RLNQLESKM	unknown
CASSVANYGYTF	KPRQKRTAT	unknown
CASSLDREAGYTF	LLSAGIFGA	unknown
CASSPQGTSDGELFF	MMFTSDLAT	unknown
CARGGQGTGANVLTF	CPACYNSEV	unknown
CAWGKTSGSSAVSYNEQFF	ALSGVFCGV	unknown
CAISESVRNGGEQYF	YPLECIKDL	unknown
CASRAGTENSPLHF	LFFSDVTWF	unknown
CSASGTGLVVRGYTF	VFLVLLPLV	unknown
CASSQLGSGALYNEQFF	TQWSLFFFL	unknown
CASSTPGRPTYEQYF	LPSYAALAT	unknown
CASSESLGTASTQYF	TILTSLLVL	unknown
CASSHRGSTEAFF	RPQGLSNNT	unknown
CASSQPGTGGFWGYTF	LVLSVNPYV	unknown
CASSRAGVDEAFF	WTAGAAAYY	unknown
CASSPIGTQGYTF	YVDDSSLTI	unknown
CATSRENSGTSNEQYF	QVVSDIDYV	unknown
CASSQVRGSTEAFF	FIDIKRGVY	unknown
CASSGGQGGTEAFF	SSSTCMMCY	unknown
CASSPSGRYTGELFF	ALNNIINNA	unknown
CASSHLDRHETQYF	RLVDPQIQL	unknown
CASSPTVVGGRNEQYF	WPLVSSQCV	unknown
CASSLTSGDNTGELFF	VVDSYYSLL	unknown
CASSGTGDYEQYF	IPVAYRKVL	unknown
CASSQDYPPGSSGNTIYF	STSAFVETV	unknown
CASSLRKGLNTEAFF	ALLAVFQSA	unknown
CASSLSVSPQYF	IMMNVAKYT	unknown
CSAIGGDGELFF	YTDIATSAC	unknown
CASSLGTRTDTQYF	VLLFLAFVV	unknown
CASSSPGSHEQFF	RTIKVFTTV	unknown
CASSLKTSGRANEQFF	YASAVVLLI	unknown
CAISESPGGNSPLHF	DPNFKDQVI	unknown
CASSRTGPVEKLFF	LVQSTQWSL	unknown
CASSQAAGVSETQYF	VPYFNMVYM	unknown
CASSSGQPQHF	LPPSYTNSF	unknown
CATSAAGDYEQYF	DQVILLNKH	unknown
CASSPPGSYGYTF	NLIDSYFVV	unknown
CASSQEGGGGLWADTQYF	KLASHMYCS	unknown
CATSDSGQGDSPEAFF	YTPSKLIEY	unknown
CASSPWGDSSDEQFF	RTIKGTYHW	unknown
CASSGTGQFMTQYF	SQLGGLHLL	unknown
CASSDTGQGTGANVLTF	IFNGECPNF	unknown
CATRTGANTGELFF	FIAGLIAIV	unknown
CASSLGLAGGPVRETQYF	YVDNSSLTI	unknown
CASSLAKRSEAFF	LPKGIMMNV	unknown
CATSVLDREIPYNEQFF	ITFDNLKTL	unknown
CASSQTEGQAEAFF	KLDDKDPQF	unknown
CATSEAGAEKLFF	HTDLMAAYV	unknown
CASSQELIPDTQYF	PMDSTVKNY	unknown
CAWSEASYGYTF	RLCAYCCNI	unknown
CASKGQGETEAFF	ETALALLLL	unknown
CASSPRIGAIETDTQYF	GIIAMSAFA	unknown
CASTERGNGELFF	FIDIKRGVY	unknown
CASIRGLGTEAFF	VMCGGSLYV	unknown
CASRAIRGQGVGYEQYF	VFLVLLPLV	unknown
CSARANTAGFKQFF	IFFITGNTL	unknown
CASSPDLGVGHYGYTF	SSSKLWAQY	unknown
CASSFTGVILYEQYF	VLWAHGFEL	unknown
CASSQGVGQGTYEQYF	MLNPNYEDL	unknown
CAWSVYLGGTGELFF	VPMEKFKTL	unknown
CASMWLGIMSSGANVLTF	VYIGDPAQL	unknown
CASSHRDRDNQYF	TLKNTVCTV	unknown
CSARNRGQGSPLHF	IPIQASLPF	unknown
CASTRQGTSTDTQYF	NTFSSTFNV	unknown
CASSASGTGVPDTQYF	IKLDDKDPN	unknown
CASNYMRGRATEAFF	LITGRLQSL	unknown
CASSVQGWANEKLFF	YVYSRVKNL	unknown
CASSLGRVGQGNSYEQYV	VMDEFIERY	unknown
CSAKSLRGNNEQFF	KDPQFKDNV	unknown
CASSDGTGDTDTQYF	FLCWHTSCY	unknown
CASSPGDRGQGYTF	VLYENQKLI	unknown
CASSRTGDYGYTF	RPQGLSNNT	unknown
CASSQDRIGETGELFF	APRITFGGL	unknown
CASQSGTQGWETQYF	YLRPRTFLL	unknown
CASSLPRTGTGELFF	IMMNVAKYT	unknown
CATQSQGSSYNEQFF	YMPYIFTLL	unknown
CASSLAKLQETQYF	KPVPEVKIL	unknown
CASSQNFQGDSPLHF	SPLPSYAAF	unknown
CASSSRVNTEAFF	GDAALALLL	unknown
CASSLATTFRGNEQFF	FPLCANGQV	unknown
CASSARDRNNSPLHF	AVASKILGL	unknown
CASSQDFRANTGELFF	VTDVTQLYL	unknown
CASSLTQGDMNTEAFF	LTDEMIAQY	unknown
CASSVSTYRGGQETQYF	AVLDMCASL	unknown
CASSWGRESSYNEQFF	FLAFVVFLL	unknown
CASSPGTVYNSPLHF	WTDNNCYLA	unknown
CASSLDVGLLDTQYF	IVNSVLLFL	unknown
CAIRGTSGTETQYF	APLLSAGIF	unknown
CSVGRMNTEAFF	LDDKDPNFK	unknown
CASSQGVQGGNEQFF	SVFNICQAV	unknown
CASSFAHGSAATNEKLFF	YYKKDNSYF	unknown
CSASPNYGYTF	MPNMLRIMA	unknown
CASSQDLEREISHEQYF	NLLKDCPAV	unknown
CASSQLPPSGLSFF	APISAMVRM	unknown
CASSQRGTDTQYF	FMSEAKCWT	unknown
CATGRGVGETQYF	LIIMRTFKV	unknown
CASSPITGYNTEAFF	TPINLVRDL	unknown
CASSSTSGLYNEQFF	RPDTRYVLM	unknown
CASSDSGGGGNTDTQYF	LLWPVTLAC	unknown
CSAFRGRDTEAFF	SSGDATTAY	unknown
CATSDFSPSGNSETQYF	IIFWFSLEL	unknown
CASSVTGDDEKLFF	FIDTKRGVY	unknown
CASITDRERNEKLFF	ALNLGETFV	unknown
CASSFGGRGYGYTF	ITSGWTFGA	unknown
CASRPGRSGADDTQYF	GLIAIVMVT	unknown
CASSLQGRKLFF	YMHHMELPT	unknown
CASSQDPAGSYNEQFF	ILPDPSKPS	unknown
CASRSPVVVAGVKVETQYF	TTEELPDEF	unknown
CASSVATGRGYNEQFF	FKDNVILLN	unknown
CSARDLGAPQETQYF	ALLSDLQDL	unknown
CSARGRGYNEQFF	KPAPRELKV	unknown
CASSVEKGSYTF	LMGHFAWWT	unknown
CASSLGNTANTGELFF	WLPTGTLLV	unknown
CASSERRVYEQFF	VENPHLMGWD	unknown
CATSRAGQNTGELFF	RSRNSSRNL	unknown
CASSLVVREVGEQFF	TYASALWEI	unknown
CAIRPLPRVSGSRGNEQFF	LTDEMIAQY	unknown
CASSLSDREETQYF	APGQTGVIA	unknown
CASSLAGRENGYTF	TLNDLNETL	unknown
CSARVAHYEQYF	MSDVKCTSV	unknown
CASSFPDGNYEQYF	LLLEWLAMA	unknown
CASSPTSGGNTGELFF	YTDINGNLH	unknown
CASSFQDYGYTF	LPNNTASWF	unknown
CASSERTGGFLAGADTQYF	CTDDNALAY	unknown
CASSTTGLGTGELFF	VLSTFISAA	unknown
CSASGGRGLNEQYF	GAIKLDDKD	unknown
CASNTQGRDGYTF	RIMTWLDMV	unknown
CASTPTATNEKLFF	RLNQLESKM	unknown
CASSAGQFLDEQYF	GVFCGVDAV	unknown
CASSQGTDSYEQYF	KWPWYIWLG	unknown
CSASRGRTEAFF	KQLIKVTLV	unknown
CASSLDVGGRTLYEQYF	FVNEFYAYL	unknown
CSARDLRQAQETQYF	LYALVYFLH	unknown
CASSRDTNTGELFF	FVVFLLVTL	unknown
CASSDSLGGNQPQHF	KQIYKTPPI	unknown
CASSQGPGRHEQYF	LSDLQDLKW	unknown
CASSPRTGRRSYGYTF	VTDVTQLYL	unknown
CASSPRTGENYGYTF	FVVFLLVTL	unknown
CASLLGNGNTEAFF	NLIDSYFVV	unknown
CAWSSGRATEAFF	AFLLFLVLI	unknown
CASSPLTGTSTDTQYF	KLNEEIAII	unknown
CATRDFNTIYF	LQAENVTGL	unknown
CASSLRVLNNQPQHF	QADVEWKFY	unknown
CATSRGANTEAFF	QPYRVVVLS	unknown
CASSPSGAYNEQFF	KLPDDFTGC	unknown
CASSDLGTSGNTIYF	WSMATYYLF	unknown
CSAKTSGGAKNIQYF	SIVAYTMSL	unknown
CASTQLGLRTEAFF	YINVFAFPF	unknown
CASSEATDGGYEQYF	FAMQMAYRF	unknown
CAWRAGQGQPQHF	APLLSAGVF	unknown
CASSETSGTDTQYF	YTNSFTRGV	unknown
CASRRTGGQQPQHF	SSDNIALLV	unknown
CASSGSGKSNQPQHF	MPLKAPKEV	unknown
CASRTGMNTEAFF	FLPFFSDVT	unknown
CASSQDPAGGPNEQFF	RLITGRLQSL	unknown
CASSESRVQPQHF	LPDDFMGCV	unknown
CASSPAMLYTF	YTDFSSEII	unknown
CASQALGATEAFF	RILGAGCFV	unknown
CASSLAVGQGYGYTF	DNVILLNKH	unknown
CAIQTLPNEQYF	LPGCDGGSL	unknown
CASSRPGLAVYEQYF	KLKDCVMYA	unknown
CASQGGGYGYTF	VTDNTFTLK	unknown
CASSLKWTGESPLHF	ITLATCELY	unknown
CASSLAGVGQFF	KPVPEVKIL	unknown
CASPVSGLAGGGETQYF	YQVNGYPNM	unknown
CASSDGGTGSTDTQYF	QLEMELTPV	unknown
CSARYGTGGEKLFF	VYAWNRKRI	unknown
CATSRGGNQPQHF	YMPYFFTLL	unknown
CASSYPDRDRGFSGNTIYF	LTALRLCAY	unknown
CASSVDPGTGNTEAFF	DQVILLNKH	unknown
CSARAVFEQFF	PVTLACFVL	unknown
CASRQRQGSEAFF	IKLDDKDPN	unknown
CASSPRSGANVLTF	LMIERFVSL	unknown
CSATEEETNEKLFF	YYTSNPTTF	unknown
CASSLGPREGLNEQFF	KPAPRELKV	unknown
CATSEAGSGNTIYF	TLIVNSVLL	unknown
CASSIKVAGTVADTQYF	ALSKGVHFV	unknown
CASSLPENEQFF	SMWSFNPET	unknown
CASIEDRDGEQYF	SMWALVISV	unknown
CASSLGAALNYGYTF	SMDNSPNLA	unknown
CASSLDLGLAPTDTQYF	YTDIATSAC	unknown
CASSEVARGRDEQYF	RLITGRLQSL	unknown
CATSDLGYEQYF	FIDIKRGVY	unknown
CATSDIRQGANTGELFF	YLDSTDVTI	unknown
CATSDLGTVGEQFF	TSNEVAVLY	unknown
CSAAQGWRQYF	VYFLQSINF	unknown
CASSYGDRGYSYEQYF	RSRNSSRNL	unknown
CASSQDEGRTGELFF	WPVTLACFV	unknown
CASSLASNSGNTIYF	WPVTLACFV	unknown
CASSSVGISYEQYF	KPADNSLKI	unknown
CASSLDVGALAHEQFF	LTALRLCAY	unknown
CASSVEGAGTDTQYF	YQVNGYPNM	unknown
CAISLQLGTDTQYF	KLASHMYCS	unknown
CASSLAGINQPQHF	RVVVLSFEL	unknown
CASTSLAGGLGDTQYF	LLLEWLAMA	unknown
CASSPYSGQLYTF	GLMWLSYFI	unknown
CATITTSGRSGELFF	FPNITNLCP	unknown
CASSSRTENTGELFF	MCDIRQLLF	unknown
CASRLGLAGVFNEQFF	IVDTVSALV	unknown
CASSPSGTNTGELFF	FMCVEYCPI	unknown
CASRQGPDYGYTF	LPNNTASWF	unknown
CSAPGLAGGGLYNEQFF	NLQSNHDLY	unknown
CSARDRPSGRRGETQYF	FVFPLNSII	unknown
CASSQGFVASSSYEQYF	KMVSLLSVL	unknown
CASSPRQVNYGYTF	SMMILSDDA	unknown
CATSRVPRTGVGEQYF	RYRIGNYKL	unknown
CASSLQTSGSNEQFF	LSFKELLVY	unknown
CAISEQVNTEAFF	SMWALIISV	unknown
CASSLGGGYQPQHF	KIYSKHTPI	unknown
CASSLGQGSWDYEQYF	IFNGECPNF	unknown
CASSETDVNYGYTF	VTDNTFTLK	unknown
CSAIGSGTEQYF	FLDGSCGSV	unknown
CASSHGLAGSYEQYF	LYALVYFLQ	unknown
CASSLGGGQADGYTF	LPPANTNSF	unknown
CASSLRDADSPLHF	TYHGAIKLD	unknown
CASSLQGAQETQYF	TLKNTVCTV	unknown
CASSPTRETQYF	TQWSLFFFL	unknown
CSAEVGGRAGREQYF	YLGGMSYYC	unknown
CASSEGGSGNTIYF	TVSCLPFTI	unknown
CASSHPDRVGKNEQFF	FVDGVPFVV	unknown
CASPGGLDLHF	RTAPHGHEL	unknown
CASSLTGARTEAFF	QELIRQGTDY	unknown
CASSIVRGSRHDTGELFF	VLSFCAFAV	unknown
CASSLNQGTGYGYTF	FYSKWYIRV	unknown
CASSENLAHRGTEAFF	IPLTTAAKL	unknown
CASSVGGRETSGRWWNEQFF	FLPFFSDVT	unknown
CASSFGVAGGQETQYF	YLQPRTFLL	unknown
CASSPTDRVTYEQYF	VLSFCAFAV	unknown
CASSYSGERDPDTQYF	IFFITGNTL	unknown
CASSLPSGNPSNTGELFF	ALWEIQQVV	unknown
CASSLGQGRLHNYGYTF	FLALCADSI	unknown
CASSPDLGLAKREETQYF	ATSRMLSYY	unknown
CSVEDKGLGGYTF	QVILLNKHI	unknown
CASSLFLGSGANVLTF	WLMWLIINL	unknown
CASSLGPQMNTEAFF	FGDDTVIEV	unknown
CASSLTGANQPQHF	VYIGDPAQL	unknown
CASSQSTPTTNEKLFF	YLGGMSYYC	unknown
CASSGPGQSYEQYF	DRLNQLESK	unknown
CASSFRGRANEQFF	YLNTLTLAV	unknown
CASSYLDLRGLPYEQYF	ILLLDQALV	unknown
CASSHSGAETEAFF	FTSDYYQLY	unknown
CASSQTPAGPYNEQFF	YVDNSSLTI	unknown
CASTRDRGSHEQYF	SLENVAFNV	unknown
CASSPPTFYGYTF	NLHPDSATL	unknown
CASSSGLAPNEQFF	IPTDFTISV	unknown
CASSPSTDTEAFF	CPACYNSEV	unknown
CASSLRGYHTQYF	RLYLDAYNM	unknown
CASSTGGTGEADTQYF	YLDSTDVTI	unknown
CSVEAQRANYGYTF	KIYSKHTPI	unknown
CASSLAGRQDYGYTF	YLDAYNMMI	unknown
CAISESGNAEKLFF	FPNITNLCP	unknown
CAIGSGTLVPDTQYF	TPINLVRDL	unknown
CASSTQGGNYGYTF	ALWEIQQVV	unknown
CASSLRRVANTGELFF	NSSTCMMCY	unknown
CASSSPGGNEQFF	FLCLFLLPS	unknown
CASKASGRTYEQYF	RIRGGDGKM	unknown
CASSSGLAGWTDTQYF	NMMVTNNTF	unknown
CASSAGRGLAGLTYEQYF	TLSEQLDFI	unknown
CSAKTGQGFATNEKLFF	QWNLVIGFL	unknown
CASSDRRNTQYF	ITFDNLKTL	unknown
CASSHGTGGEQYF	TVYEKLKPV	unknown
CASSVTGREKLFF	MPYIFTLLL	unknown
CASSPGLAGGPNTDTQYF	NVLTLVYKV	unknown
CASTLLGSSYNEQFF	YTDIATSAC	unknown
CASSLTGNVNEQFF	VMPLSAPTL	unknown
CASSLDGQGWYEQYF	FLPFAMGII	unknown
CASSVLVVETQYF	FPLTSFGPL	unknown
CASSQDHEQYF	TTIQTIVEV	unknown
CSARSIMGGRRYTF	FLPRVFSAV	unknown
CSARGGGRARETQYF	SIIAYTMSL	unknown
CASSVLSSVEGELFF	YGFQPTNGV	unknown
CASGTRWGGGKETQYF	YQDVDCTEV	unknown
CASSFTGLNTGELFF	NPANNAAIV	unknown
CASSFLWTDSGNTIYF	NVFAFPFTI	unknown
CASSLVPNEKLFF	NMLRIMASL	unknown
CASSLVGRTETQYF	TSNEVAVLY	unknown
CSVEVRGRGAGAGANVLTF	SPRRARSVA	unknown
CASSSTSGFRYEQFF	LDDKDPNFK	unknown
CASSLGIGGNQPQHF	TSQWLTNIF	unknown
CASSIRGLATETQYF	FISTCACEI	unknown
CASSQRGQAYEQYF	VMHANYIFW	unknown
CASSQGGPRRYGYTF	TYHWLLLTI	unknown
CSARRSSNQPQHF	FMIDVQQWG	unknown
CASSGLLQRETQYF	NLLKDCPAV	unknown
CASSLARQGAREQFF	LLFLVLIML	unknown
CASIVGRGARELFF	LLNKHIDAY	unknown
CASSELAGNYNEQFF	VTLAILTAL	unknown
CASSPSRDWSSYNEQFF	GDAALALLL	unknown
CASSQNPGHRTDTQYF	FLPGVYSVI	unknown
CSARDGRVDQETQYF	TLIVNSVLL	unknown
CASSPGGTPWEQYF	KQLSSNFGA	unknown
CSLTRAGGIYNEQFF	SFLPGVYSV	unknown
CSARDPSLCTF	RIMASLVLA	unknown
CASTQVIKGQYEQYF	FAFPFTIYS	unknown
CSVDAWGADGYTF	KLIEYTDFA	unknown
CASSQRSEGLNYGYTF	SVAALTNNV	unknown
CASSLTGGRLESQYF	VFLVLWPLV	unknown
CASSQIAGGPHEQYF	MLSDTLKNL	unknown
CSVEDGIYEQYF	RLYLDAYNM	unknown
CAWERGERSYNEQFF	LVQSTQWSL	unknown
CASSPGVGPRETQYF	FKDQVILLN	unknown
CASSLRGLNYGYTF	RLCAYCCNI	unknown
CASSYSISSQGRNEQFF	DYKHYTPSF	unknown
CASKQGGFGYEQYF	LPPAYTNSF	unknown
CSAIGGRITDTQYF	LTYHGAIKL	unknown
CASSIASSGGFNEQFF	MLFTMLRKL	unknown
CASSPGLTYNEQFF	HGAIKLDDK	unknown
CASAEALVFDGDTQYF	APLLSAGIF	unknown
CASSPPSGFREQYF	LMNVLTLVY	unknown
CASSISDNQPQHF	NFSKLINII	unknown
CASSYSSGGGELFF	SPRWYFYYL	unknown
CASSLLGNPTDTQYF	NVLTLVYKV	unknown
CSARSGELAGDEQFF	CVMYASAVV	unknown
CASSRSGGSQPQHF	GLMWLSYFI	unknown
CASSGTSGTYEQYF	IQPGQTFSV	unknown
CASSSGTGGLNYGYTF	KLKDCVMYA	unknown
CSARPRSLREQYF	DNVILLNKH	unknown
CASSSQNGQPQHF	YYQLYSTQL	unknown
CASSSVWGNNSPLHF	YVDDSSLTI	unknown
CASSQDRESRFF	LMWLIINLV	unknown
CASSAQQGRGEKLFF	YTDFATSAC	unknown
CASSSWTARGTQYF	FVDGVPFVV	unknown
CASSFAGPETQYF	ILTSLLVLV	unknown
CASSLGQTDTQYF	YLNSTNVTI	unknown
CAISVPSRPDTQYF	FLPFAMGII	unknown
CASSHPTSGSHHEQYF	FTPLVPFWI	unknown
CSASPSGGSYEQYF	YTDIATSAC	unknown
CASRPTGLGAGYTF	NLSDRVVFV	unknown
CASSLGLGADTQYF	HLLLVAAGL	unknown
CSAALGGKGGNEQFF	KLMPVCVET	unknown
CASRFSSGPLGQFF	LYALVYFLQ	unknown
CASSEWKASGTQETQYF	KLPDDFMGC	unknown
CASTAGGTSGGIYNEQFF	KVDGVDVEL	unknown
CSVDPPGSPEQYF	SMMILSDDA	unknown
CASSAAGHLQFF	AIFYLITPV	unknown
CASSLDEAQSDTQYF	SSDNIALLV	unknown
CAISVSRGGNTIYF	LPDDFMGCV	unknown
CATRTGSDEQFF	FWITIAYII	unknown
CASSSGGWSYNEQFF	WPWYIWLGF	unknown
CASSLLQGNSPLHF	LLSAGIFGA	unknown
CASTTSSMGNIQYF	FVFLVLLPL	unknown
CASSQVTGTNSPLHF	KLIEYTDFA	unknown
CASSLTGAGANVLTF	RIRGGDGKM	unknown
CASSPTPGTGGVGGYTF	YVYSRVKNL	unknown
CASSQSQGHERYGYTF	NFSKLINII	unknown
CASSELGGRSSSYNEQFF	RLNQLESKM	unknown
CASSLVLGVGTPEFF	YYQLYSTQL	unknown
CAWSFGISGNTIYF	NPTIQKNVL	unknown
CASLPSGSPRAQYF	QLCTQHQPY	unknown
CSVTAQGYEQYF	TMADLVYAL	unknown
CASSFTGTGETYNEQFF	TLATHGLAAV	unknown
CASDKFGDYNEQFF	ELTSMKYFV	unknown
CASSQGAGAHYGYTF	VLSFCAFAV	unknown
CASSERVLAYYNEQFF	LFTRFFYVL	unknown
CASSPTGTGANVLTF	CLGSLIYST	unknown
CASSKDRTNEKLFF	SLLSVLLSM	unknown
CASSLVWGYTF	TSAMHTMLF	unknown
CASSRGGNNSPLHF	YTDINGNLH	unknown
CASSFAESYEQYF	LPGCDGGSL	unknown
CATSRADIYEQYF	ILLLDQALV	unknown
CASSEWSDRGYTF	GTDLEGNFY	unknown
CAWRGTGLPNTQYF	VYIGDPAQL	unknown
CASSPQGRVNTEAFF	HVYQLRARL	unknown
CASSMGQVAYEQYF	KLDGFMGRI	unknown
CSARTGGITGELFF	MPLSAPTLL	unknown
CASSRRTGEDYGYTF	SMDNSPNLA	unknown
CSARTGAANTGELFF	TLIVNSVLL	unknown
CASSQLLAGGPKNIQYF	HLLLVAAGL	unknown
CASSPPGQDEQYF	FVDGVPFVV	unknown
CASSLSKQGYYGYTF	KVSIWNLDY	unknown
CASMIAGGYYNEQFF	VLQVRDVLV	unknown
CAWDMATYEQYF	LQLGFSTGV	unknown
CASSLVLGIYNEQFF	ALNLGETFV	unknown
CAISEDRGPETQYF	MFDAYVNTF	unknown
CASSPNDRRYQQYF	YLGGMSYYC	unknown
CSAPAGVSDTQYF	YTERSEKSY	unknown
CASSLLQGRETQYF	VLAWLYAAV	unknown
CASSPGNTYEQYF	IVNSVLLFL	unknown
CASSDLGGPQGSYNEQFF	KPLPEVKIL	unknown
CASSPVRQGAWGQETQYF	IVNSVLLFL	unknown
CASSQDREFDEQYF	VMVELVAEL	unknown
CASKEGRGSPLHF	ATSRTLSYY	unknown
CASSLRGGVQPQHF	YASAVVLLI	unknown
CASSSQGGRGTQYF	LQNNELSPV	unknown
CASNWAGGEAFF	PVTLACFVL	unknown
CASSFLHSNTIYF	YINVFAFPF	unknown
CASGGERENEQYF	STECSNLLL	unknown
CASSLMAANTGELFF	VTWFHAIHV	unknown
CASSPLAGSGQPQHF	FWITIAYII	unknown
CASKFRAGHYEQYF	TLLFLMSFT	unknown
CASSRQGWDEQFF	KWPWYIWLG	unknown
CASSYARNTGELFF	NLSDRVVFV	unknown
CASSPYDSNQPQHF	WLMWLIINL	unknown
CASSLRTSGTVEQFF	RTIKVFTTV	unknown
CAISESDGGRGEQYF	ALLADKFPV	unknown
CASSRPSYNEQFF	FLAFVVFLL	unknown
CASSSPRTGVESTNF	GLALYYPSA	unknown
CASSWGQGETQYF	MMILSDDAV	unknown
CAISETQGADYGYTF	KLFIRQEEV	unknown
CASSRDTPNEKLFF	VYSTGSNVF	unknown
CATSSQGSNEKLFF	QELIRQGTDY	unknown
CASSQPTGRLTYNSPLHF	LLFLMSFTV	unknown
CASSLTGTGTMNTEAFF	SWMESEFRV	unknown
CASSQGQGNSPLHF	KIILFLALI	unknown
CASSYGTGGDFYGYTF	YLGGMSYYC	unknown
CASSMVANNEQFF	MLAKALRKV	unknown
CASSLKGGLSGANVLTF	IVAGGIVAI	unknown
CASSYPRQGNYEQYF	LDDKDPNFK	unknown
CASSISGRGTGELFF	AMDEFIEQY	unknown
CSARDKGARPNIQYF	VPYFNMVYM	unknown
CSVSGTSFDEQYF	FVFLVLLPL	unknown
CASSFRAGGPLEQYF	FPLCANGQV	unknown
CASSTGTAYNEQFF	YINVFAFPF	unknown
CASSFFVDREGYEQYF	TSQWLTNIF	unknown
CASSTDRENTEAFF	TGAIKLDDK	unknown
CAVFPNINQPQHF	STSAFVETV	unknown
CASSLTAGRADTQYF	MFLARGIVF	unknown
CASSFGDRGEQYF	RTAPHGHVV	unknown
CASSLGGASGYTF	KSVDITFEL	unknown
CASSIGGRRYTF	LVLSVNPYV	unknown
CASTAAGAYNEQFF	FLGRYMSAL	unknown
CASSAGTSGDTDTGELFF	LLTNMFTPL	unknown
CATPRRDNKETQYF	YIDIGNYTV	unknown
CASSFAGRQETQYF	VMHANYIFW	unknown
CASSRPPTDTQYF	FLNGSCGSV	unknown
CASSQTRQGVGGNTIYF	STDVTIATY	unknown
CASSLKGGEPRYEQYF	ALLADKFPV	unknown
CASSFIQGSYNSPLHF	SLIYSTAAL	unknown
CASSLLDSRTYEQYF	RLNQLESKM	unknown
CASSSLRDRAGELFF	YINVFAFPF	unknown
CASSVVGEGLNSDTQYF	YGFQPTNGV	unknown
CSAGRLRGRSKNNEQFF	LTALRLCAY	unknown
CSARDLQGASAFF	YLNSTNVTI	unknown
CASSLTKDNEQFF	AEVQIDRLI	unknown
CATSDSASGRGRDTQYF	TGAIKLDDK	unknown
CASSLPPDHTQYF	KWPWYIWLG	unknown
CRAAGSFYEQYF	SPRRARSVA	unknown
CASSQGPSVEETQYF	LQAENVTGL	unknown
CSARDLTDNLQETQYF	FLLPSLATV	unknown
CASSDSRYNEQFF	ELTSMKYFV	unknown
CASALYRGGGETQYF	FLWLLWPVT	unknown
CASSLGLGPYEQYF	KVYPIILRL	unknown
CASSKDRAREEQFF	FLPFFSDVT	unknown
CASGKGQGREKLFF	ALNTPKDHI	unknown
CASSFTGGAGYTF	ALALLLLDR	unknown
CAGPGTDSYEQYF	APGQTGVIA	unknown
CASSPDQWRQSETQYF	KIILFLALI	unknown
CASGLGAFGGEQYF	AMDEFIERY	unknown
CASRGLAGVNEQFF	FPLTSFGPL	unknown
CASSQAPRELVIDTQYF	GTDLEGNFY	unknown
CASTLMGGSYEQYF	GDAALALLL	unknown
CASSHSGPEQFF	VQMAPISAM	unknown
CASSVDGSAGYGYTF	SMWALIISV	unknown
CASRGTDRSSYNSPLHF	KLLKSIAAT	unknown
CSASERGSKRELFF	SPRWYFYYL	unknown
CASRRAGAGGYNEQFF	LTNDDTSRY	unknown
CASSSPSPPSETQYF	VTDVTQLYL	unknown
CASSDLAGGSNEQFF	DTDFVNEFY	unknown
CASSLDHSNNEQFF	APHGVVFLH	unknown
CASSHRGQGLTEAFF	LITGRLQSL	unknown
CASISGLGNTGELFF	KISEMHPAL	unknown
CASTLGGSTDTQYF	TLACFVLAA	unknown
CASSQQGLRIYTF	VLLSMQGAV	unknown
CASSESGNEQFF	SLSSTASAL	unknown
CSATLAGAGETQYF	RPPLNRNYV	unknown
CAWSGGVVNTEAFF	PMDSTVKNY	unknown
CSARVRENYGYTF	KQLIKVTLV	unknown
CSARGGTSGSQYEQYF	KPASRELKV	unknown
CASSGSRANNQPQHF	KWPWYIWLG	unknown
CASSPPGGRRNTEAFF	FVFLVLLPL	unknown
CASSLALSEADFF	FVVFLLVTL	unknown
CSARGSWETQYF	RLQSLQTYV	unknown
CASSLRGVGVEKLFF	ALYYPSARI	unknown
CSARDPAGGYEQYF	TWLTYTGAI	unknown
CASSASPAGGDGYTF	QVILLNKHI	unknown
CASSSPGHVRPLYGYTF	LDRLNQLES	unknown
CASSGRDRDRDRGAVFF	IIFWFSLEL	unknown
CASSFAGSSYEQYF	FLLPSLATV	unknown
CASSLALLGFSYEQYF	FTSDYYQLY	unknown
CASSSRRLAGGGETQYF	LMNVLTLFY	unknown
CSASLAEETQYF	ALNNIINNA	unknown
CASSLLGSYNSPLHF	LIDFYLCFL	unknown
CASSLSTGTDTQYF	IPLTTSSKL	unknown
CSARRGLAGVGELFF	SSSKLWAQY	unknown
CASSGGGRASYEQYF	KPASRELKV	unknown
CASSPQGLAGYTDTQYF	NLLKDCPAV	unknown
CASSLVVATSGANVLTF	IKLDDKDPQ	unknown
CASSHSRDTQYF	RARSVASQSI	unknown
CASSYSEGVDGELFF	LPPAYTNSF	unknown
CSARPGVTEAFF	VTDVTQLYL	unknown
CASRLKGENEKLFF	WSMATYYLF	unknown
CASSFTGTGELFF	FPLKLRGTA	unknown
CASSLGGNSYNSPLHF	AVLDMCASL	unknown
CASSLEVTGNYNEQFF	MASGGGETA	unknown
CSANSLAESTDTQYF	AIMTRCLAV	unknown
CASSQESRTGELFF	EWSMATYYL	unknown
CASSTGTSGQPQHF	FLGIITTVA	unknown
CASRSGTSGTDTQYF	QLLFVVEVV	unknown
CASSSLVATLAGEQYF	LFFSDVTWF	unknown
CAWNFSPAGLDEQFF	NMMVTNNTF	unknown
CASSPRNYEQYF	KLPDDFTGCV	unknown
CASRSQGLLNEQFF	ELSLIDFYL	unknown
CASSSLAGGRRNGYTF	FVVFLLVTL	unknown
CASSQASSGTNEQFF	GLMWLSYFV	unknown
CASSLTDYTEAFF	RLQSLQTYV	unknown
CASSQGFRGVNEQFF	FLKKDAPYI	unknown
CASSLVREGRYNEQFF	ALNLGETFV	unknown
CASSVLQEGYTF	SSGDATTAY	unknown
CASSVAHGPSGNTIYF	LPKGIMMNV	unknown
CASSLVPGVSYEQYF	KQLPFFYYS	unknown
CASSRRTDYNEQFF	YTACSHAAV	unknown
CASPLGGPTDTQYF	FVFLVLLPL	unknown
CASSVTGGNEQFF	TSAMQTMLF	unknown
CASSLSVGDSPLHF	RLYLDAYNM	unknown
CASSPEGSGGGTDTQYF	WPWYIWLGF	unknown
CASSYIGTTSTDTQYF	YMPYIFTLL	unknown
CSARLAGAWDTQYF	CLGSLIYST	unknown
CASSSNIIRGNEQFF	NLLKDCPAV	unknown
CSAGEGQENQPQHF	ALYYPSARI	unknown
CASSQERLAETQYF	RYRIGNYKL	unknown
CASSLGQGVRETQYF	YYKKDNSYF	unknown
CASSLLSPSGGSTDTQYF	TPRDLGACI	unknown
CASSSLGTGPQETQYF	DNVILLNKH	unknown
CASSLERLAGAVKNIQYF	LPSYAAFAT	unknown
CASSTRGLLNTEAFF	LLMPILTLT	unknown
CASALFGSGANVLTF	YYTSNPTTF	unknown
CASRQLDREVGELFF	PTDQSFYIV	unknown
CASGRQANTEAFF	IPVAYRNVL	unknown
CASSLEGTAYYEQYF	LQLGFSTGV	unknown
CAWSILAVQSYNEQFF	YLAVFDKNL	unknown
CASSLRETEEQFF	RLNQLESKM	unknown
CASSFWSSDQETQYF	NSAIGKIQY	unknown
CAWSPVANYGYTF	LLALHRSYL	unknown
CASRRQAYSNQPQHF	ISQWLTNIF	unknown
CASSQDHADRDYEQYF	LPSYAALAT	unknown
CATSRDRGGTEAFF	ELYSPIFLI	unknown
CASSQKGTGLGHEQYF	YVFCTVNAL	unknown
CASSPRGGRLDYGYTF	KPRQKRTAT	unknown
CASSKPGTENSPLHF	LDRLNQLES	unknown
CASREGRTSTDTQYF	APISAMVRM	unknown
CASSHGTGRGYTF	PTDQSFYIV	unknown
CASTGGYEQYF	YLRPRTFLL	unknown
CASMPRVAKNIQYF	RLCAYCCNI	unknown
CSVEDQGGRALTYEQFF	RLITGRLQSL	unknown
CASSYDGQGYEQYF	IFFITGNTL	unknown
CASSRSAGEQFF	STDVTIATY	unknown
CASSFSGSRTGELFF	TSNEVAVLY	unknown
CASSTGTSGTRDGELFF	VLLSMQGAV	unknown
CASSRQGDGYTF	LLWPVTLAC	unknown
CASRLPGNTEAFF	ELSLIDFYL	unknown
CASIPAGRAYEQYF	LPSYAALAT	unknown
CASSSSQDRGDYEQYF	MEVTPSGTWL	unknown
CASSQDLNQPQHF	SIIAYTMSL	unknown
CASSGREKTYEQYF	VFLVLWPLV	unknown
CASSSKNRAPGANVLTF	FLWLLWPVT	unknown
CSARRGGQDPRGSGANVLTF	IPTITQMNL	unknown
CASSRGVQGANYGYTF	ALVYFLQSI	unknown
CATSEKDYGYTF	LSDLQDLKW	unknown
CASSEEEAKPYEQYF	RIMTWLDMV	unknown
CASSGSGAVAKNIQYF	TLIGDCATV	unknown
CASSRDRDGVLYGYTF	PVTLACFVL	unknown
CASSQGPTNTGELFF	APGQTGVIA	unknown
CSVEDTGGSYTF	LSDRVVFVL	unknown
CASSSHNPVEGGYTF	VQMAPISAM	unknown
CASSLGQPDNEQFF	NTFSSTFNV	unknown
CASSFWGEGTDTQYF	KPVETSNSF	unknown
CASSLGGAGGADTQYF	RLQSLQTYV	known
CASSPDIEQYF	YLQPRTFLL	known
CAGQVTNTGELFF	YLQPRTFLL	known
CASSLAGYEQYF	LTDEMIAQY	known
CASSLGFPNQPQHF	LTDEMIAQY	known
CASSDDGTGIETQYF	TTDPSFLGRY	known
CASSEGITSNQPQHF	LTDEMIAQY	known
CASSQEPRDASSYNEQFF	QYIKWPWYI	known
CASSNPGPWGSPLHF	LTDEMIAQY	known
CASQGGAGYLYGYTF	LTDEMIAQY	known
CASSLKTDSYEQYF	PTDNYITTY	known
CASSVSQGYEQFF	NYNYLYRLF	known
CASSLAVNTEAFF	LTDEMIAQY	known
CASSLSLGQGAPNYGYTF	NQKLIANQF	known
CAWSVTPGYNEQFF	RVAGDSGFAAY	known
CASSLALAGIRYNEQFF	LTDEMIAQY	known
CASSLGLAGGASYNEQFF	LTDEMIAQY	known
CASSEYRPPYEQYF	NYNYLYRLF	known
CASSITDRVHAGANVLTF	LLYDANYFL	known
CSAGGTGIYGSYEQYF	YLQPRTFLL	known
CASSPDIEAFF	YLQPRTFLL	known
CASTDRWAGDTQYF	TTDPSFLGRY	known
CASSFPLGGYGYTF	TTDPSFLGRY	known
CASSLDNSPLHF	TTDPSFLGRY	known
CASSDTQGSQPQHF	LTDEMIAQY	known
CASSLGAGGSGEQYF	TTDPSFLGRY	known
CASSLVGGAGEQYF	TTDPSFLGRY	known
CASGPPGTGYSNQPQHF	QYIKWPWYI	known
CASKQGWSNQPQHF	TTDPSFLGRY	known
CASSDRTSQETQYF	TTDPSFLGRY	known
CASSQDPGRGSPLHF	YLQPRTFLL	known
CASSGDREQFF	TTDPSFLGRY	known
CASTYSGRVGPGELFF	NQKLIANQF	known
CASSFKTDAYEQYF	PTDNYITTY	known
CASINRAANTGELFF	LTDEMIAQY	known
CASSLYGSRPQHF	ALSKGVHFV	known
CASSLDVPYEQYF	RVAGDSGFAAY	known
CSARDVAGGAHYEQYF	QYIKWPWYI	known
CASSLDIELFF	YLQPRTFLL	known
CASSQGETQYF	QELIRQGTDY	known
CASSGGYEQYF	YLQPRTFLL	known
CASSEAGGYEQYF	NYNYLYRLF	known
CASGTGGTETQYF	TTDPSFLGRY	known
CAWSVGGSWVGELFF	LTDEMIAQY	known
CASSLVETNYGYTF	LTDEMIAQY	known
CASMDENTGELFF	YLQPRTFLL	known
CASSNRGGNEQFF	NQKLIANQF	known
CASSDSDGTTDTQYF	YLQPRTFLL	known
CASDSGYTEAFF	TTDPSFLGRY	known
CASSLTLRGGAGELFF	NQKLIANQF	known
CASSASNGGGETQYF	TTDPSFLGRY	known
CASSQDVGQGVLYGYTF	LTDEMIAQY	known
CASIVRNSLEAFF	YLQPRTFLL	known
CSVHQGWPYEQYF	LTDEMIAQY	known
CSAGERNTGELFF	YLQPRTFLL	known
CASSRENYGYTF	QELIRQGTDY	known
CASSLSLIYEQYF	TTDPSFLGRY	known
CASSSRAGATDTQYF	TTDPSFLGRY	known
CAISGPETNQPQHF	LTDEMIAQY	known
CAEQDMNTGELFF	YLQPRTFLL	known
CASSQEWREFLREQFF	TTDPSFLGRY	known
CASSPGGAGLVNEQYF	NQKLIANQF	known
CASSWREGTDTQYF	VYFLQSINF	known
CASKGGQETQYF	TTDPSFLGRY	known
CASSLSDSYEQYF	TTDPSFLGRY	known
CASSYMGEGEQFF	TTDPSFLGRY	known
CASSPSGAGGGDEQFF	NQKLIANQF	known
CASSIATGLNQPQHF	NTNSSPDDQIGYY	known
CASRLQGAGTEAFF	TTDPSFLGRY	known
CAWGGSTGDNSPLHF	TTDPSFLGRY	known
CASMLRWANTGELFF	LTDEMIAQY	known
CASSQGPNGYTF	YLQPRTFLL	known
CASRLGTGEVGELFF	YLQPRTFLL	known
CASSPDIEAFF	YLQPRTFLL	known
CASSARTGELFF	YLQPRTFLL	known
CASSLYISVGSNTEAFF	TTDPSFLGRY	known
CASSPTSGSTDTQYF	TTDPSFLGRY	known
CASSQGGGVNEQFF	DTDFVNEFY	known
CALGSANTGELFF	YLQPRTFLL	known
CASSLGGGLNYGYTF	TTDPSFLGRY	known
CASSLGGPGTGYEQYF	LTDEMIAQY	known
CASSQKAAQGVSSYEQYF	YLQPRTFLL	known
CASSLPTGETQYF	TTDPSFLGRY	known
CASSLAHQTYEQYF	LTDEMIAQY	known
CASSFGDRGREKLFF	YLQPRTFLL	known
CASSPDIEAFF	YLQPRTFLL	known
CSARDPWQVNTGELFF	YLQPRTFLL	known
CASSPDIEAFF	YLQPRTFLL	known
CSATKDRGYTEAFF	NQKLIANQF	known
CSVHQGFPYEQYF	LTDEMIAQY	known
CASSLAEGPRYGYTF	YLQPRTFLL	known
CASSLVGYEQYF	FTSDYYQLY	known
CASSISGFDGYTF	YLQPRTFLL	known
CASSHGGPGGLNEQFF	YLQPRTFLL	known
CASTIQANYGYTF	VYFLQSINF	known
CASSLGASSYNEQFF	YLQPRTFLL	known
CASSRNRYTDTQYF	YLQPRTFLL	known
CASSPDIEAFF	YLQPRTFLL	known
CASNFGLPFGNEQFF	LTDEMIAQY	known
CASSFEDTNYGYTF	NQKLIANQF	known
CASSWTSGSHEQYF	TTDPSFLGRY	known
CASSSDISAFF	YLQPRTFLL	known
CASSSDLGGGTDTQYF	TTDPSFLGRY	known
CASTETNTGELFF	YLQPRTFLL	known
CASSTLAEETQYF	QYIKWPWYI	known
CSARDLGAQNTGELFF	YLQPRTFLL	known
CASSKLVANTGELFF	LTDEMIAQY	known
CASSPNPTYEQYF	NYNYLYRLF	known
CASRGGVGANNEQFF	LTDEMIAQY	known
CASRRKIYEQYF	YLQPRTFLL	known
CASSPDIEAFF	YLQPRTFLL	known
CASSEQNTGELFF	YLQPRTFLL	known
CASSVIQGAAGELFF	LTDEMIAQY	known
CASSQEDRWVIGELFF	TTDPSFLGRY	known
CASSDANTGELFF	YLQPRTFLL	known
CASTDGGFGYTF	TTDPSFLGRY	known
CASSQSGLAGIFSYNEQFF	QYIKWPWYI	known
CASSPTHSTDTQYF	TTDPSFLGRY	known
CSANTYDEVQETQYF	FTSDYYQLY	known
CSARGDRGEGYEQYF	LTDEMIAQY	known
CASSPGRMSSRYEQYF	TTDPSFLGRY	known
CASSLDIEAFF	YLQPRTFLL	known
CSVRGPYGAYEQYF	FTSDYYQLY	known
CASSYSNRYPGGYTF	NQKLIANQF	known
CASSQRTDSYEQYF	PTDNYITTY	known
CASSMRSGSDEQYF	TTDPSFLGRY	known
CASHPGTGTSSYNSPLHF	LTDEMIAQY	known
CASTDSDTQYF	TTDPSFLGRY	known
CASSLILAGLNQPQHF	TTDPSFLGRY	known
CASSLGAGTYEQYF	LTDEMIAQY	known
CASSPGFPEQFF	TTDPSFLGRY	known
CASSQDHYEQYF	LLYDANYFL	known
CASSFAAGSYNEQFF	TTDPSFLGRY	known
CATKPDTNTEAFF	NTNSSPDDQIGYY	known
CASSLVPQGPNYGYTF	LTDEMIAQY	known
CSVVVISADTQYF	TTDPSFLGRY	known
CATGLGFDYGYTF	LTDEMIAQY	known
CASSYPRRSSSYNEQFF	TTDPSFLGRY	known
CASSRGAGHSDGYTF	LTDEMIAQY	known
CASSTSSPQETQYF	TTDPSFLGRY	known
CASSTGGRGEQFF	LTDEMIAQY	known
CSARVLTSGETYEQYF	YLQPRTFLL	known
CASSFFSPPDRFIYVYEQYF	NQKLIANQF	known
CARGDRNTGELFF	YLQPRTFLL	known
CASSHPSEGSRKKYEQYF	YLQPRTFLL	known
CASSYLMTGNEQYF	FTSDYYQLY	known
CASSPQGVTQYF	TTDPSFLGRY	known
CASSLDIEAFF	YLQPRTFLL	known
CASSFAVNTEAFF	LTDEMIAQY	known
CASSVKPDSPAEAFF	YLQPRTFLL	known
CSARDAGLAGLEQFF	QYIKWPWYI	known
CASSSRAASTDTQYF	TTDPSFLGRY	known
CASSQDLADRGYTF	NYNYLYRLF	known
CASSPRDHQETQYF	TTDPSFLGRY	known
CASSLIRDITYEQYF	VYIGDPAQL	known
CASSLSPFSADYEQYF	NQKLIANQF	known
CASSYDNGGNTGELFF	LTDEMIAQY	known
CASSVGLAGVYSYNEQFF	LTDEMIAQY	known
CASGSTEQYF	VYFLQSINF	known
CASSAGDSDGYTF	TTDPSFLGRY	known
CASRTAGNEQYF	TTDPSFLGRY	known
CSVASSEAFF	TTDPSFLGRY	known
CATSDLGPTGELFF	TTDPSFLGRY	known
CAIGTGPMNTEAFF	TTDPSFLGRY	known
CASDLLNRASYEQYF	TTDPSFLGRY	known
CASSHSMGYEQYF	NYNYLYRLF	known
CASSAFRGEGEKLFF	TTDPSFLGRY	known
CALSDQNTGELFF	YLQPRTFLL	known
CSGEEGPLGETQYF	QYIKWPWYI	known
CAINKESDSYEQYF	PTDNYITTY	known
CASSQTGGLQSHEQFF	FTSDYYQLY	known
CASSLRTDSYEQYF	PTDNYITTY	known
CASSHFVLGPRGGETQYF	LTDEMIAQY	known
CASSYGQGITFF	TTDPSFLGRY	known
CASSTRATNEKLFF	TTDPSFLGRY	known
CASSDSGFGYGYTF	LTDEMIAQY	known
CASSLTSGAYNEQFF	NQKLIANQF	known
CASSLALAGRNYNEQFF	LTDEMIAQY	known
CASSLDWNYGYTF	LTDEMIAQY	known
CASSEFRSPYEQYF	NYNYLYRLF	known
CASSLNRGQETQYF	FTSDYYQLY	known
CASSLDSSYEQYF	TTDPSFLGRY	known
CAISESRGAVETQYF	NQKLIANQF	known
CATRGEGAQYSPLHF	LTDEMIAQY	known
CASSVTGQGRETQYF	NQKLIANQF	known
CASSLTGGGYTF	NQKLIANQF	known
CASSERTGYEAFF	NYNYLYRLF	known
CASSTGGVGYEQYF	NQKLIANQF	known
CASSADIEAFF	YLQPRTFLL	known
CASSQGGSADTQYF	NQKLIANQF	known
CSVEVSDYEQYF	NQKLIANQF	known
CASRDEGRGRYGANVLTF	LTDEMIAQY	known
CASSSDPSSDYEQYF	TTDPSFLGRY	known
CASSPVGWDTEAFF	LTDEMIAQY	known
CASSRDIEAFF	YLQPRTFLL	known
CASGLGIGQNIQYF	NQKLIANQF	known
CASSLVSPGFGTEAFF	YLQPRTFLL	known
CASSPGGAGLVNEQYF	NQKLIANQF	known
CATSAASGRAYNEQFF	TTDPSFLGRY	known
CASSLDIEQYF	YLQPRTFLL	known
CASSLTAPTDTQYF	TTDPSFLGRY	known
CASSPGPETGELFF	TTDPSFLGRY	known
CASSLTQGLNTEAFF	TTDPSFLGRY	known
CASSGLAGTAGETQYF	TTDPSFLGRY	known
CASSLTGTSNQPQHF	TTDPSFLGRY	known
CASSLWLNNEQFF	ALSKGVHFV	known
CASQILNTGELFF	YLQPRTFLL	known
CASSLSAGLDEQFF	TTDPSFLGRY	known
CASSQGGDDTEAFF	LTDEMIAQY	known
CSVGTGWPYEQYF	LTDEMIAQY	known
CASREGRAYNEQFF	LTDEMIAQY	known
CASGLADTDTQYF	TTDPSFLGRY	known
CASSQAQAGNTIYF	YLQPRTFLL	known
CASSWGGANNEQFF	VYFLQSINF	known
CASTLNLGQGAPHYGYTF	NQKLIANQF	known
CASSPDIEQYF	YLQPRTFLL	known
CASSLGIGTQPQHF	LTDEMIAQY	known
CASSMGAISEAFF	YLQPRTFLL	known
CSVEGVLADYNEQFF	FTSDYYQLY	known
CSAYDRGVSSNQPQHF	YLQPRTFLL	known
CASSLRSGQDEQFF	TTDPSFLGRY	known
CASSSRQGPKEYGYTF	LTDEMIAQY	known
CSARDRTSGTYEQYF	TTDPSFLGRY	known
CASTGQNNEQFF	VYFLQSINF	known
CAWQVMNTGELFF	YLQPRTFLL	known
CAWRHFDTEAFF	QELIRQGTDY	known
CASSYSTTGRYEQFF	TTDPSFLGRY	known
CATQDGNTGELFF	YLQPRTFLL	known
CASLNRAANTGELFF	LTDEMIAQY	known
CASSLVGTSGRPAGDEQFF	YLQPRTFLL	known
CASYSGTVNSPLHF	TTDPSFLGRY	known
CASPDANTGELFF	YLQPRTFLL	known
CASRPPGADTEAFF	TTDPSFLGRY	known
CASGEANTGELFF	YLQPRTFLL	known
CASSWDRFNEQFF	YLQPRTFLL	known
CASGDENTGELFF	YLQPRTFLL	known
CASSAGDYGYTF	TTDPSFLGRY	known
CASSSRHSGEKLFF	LTDEMIAQY	known
CSARDPAGVGVDEQYF	FTSDYYQLY	known
CASSTRDSNQPQHF	YLQPRTFLL	known
CARRGDRAEQYF	LTDEMIAQY	known
CASSPHPSDTQYF	YLQPRTFLL	known
CASTKGGTDTQYF	TTDPSFLGRY	known
CASSPQVISGSTDTQYF	LTDEMIAQY	known
CASSGPLAGRRTDTQYF	LTDEMIAQY	known
CSARDYLTSGRGGTYEQYF	NQKLIANQF	known
CASRQAGDEQYF	TTDPSFLGRY	known
CASSPEDTQYF	YLQPRTFLL	known
CASSEQGGYEQYF	NYNYLYRLF	known
CAMTTQSSYEQYF	TTDPSFLGRY	known
CSASASGRIAFF	YLQPRTFLL	known
CASSLDSPYEQYF	TTDPSFLGRY	known
CASSLRQGADTQYF	TTDPSFLGRY	known
CASSSRQGWYF	NTNSSPDDQIGYY	known
CASSTLSVSGYTF	NQKLIANQF	known
CASRTDGLAGYNEQFF	YLQPRTFLL	known
CASSLEDTYYGYTF	NQKLIANQF	known
CASSGTVTSSSTDTQYF	LTDEMIAQY	known
CASSIPASGTLEQFF	TTDPSFLGRY	known
CAFGQQNTGELFF	YLQPRTFLL	known
CASSLLPEQETQYF	TTDPSFLGRY	known
CASSLGGEGKTQYF	YLQPRTFLL	known
CASSDRAPSSDTQYF	TTDPSFLGRY	known
CASSHGGDWDQPQHF	FTSDYYQLY	known
CAWTRRDGGELFF	LTDEMIAQY	known
CATQGMNTGELFF	YLQPRTFLL	known
CASSEESSRYYGYTF	NQKLIANQF	known
CASWTDSQGETQYF	TTDPSFLGRY	known
CASRYGGQGDSEQFF	YLQPRTFLL	known
CASSLGGTEAFF	LLYDANYFL	known
CASSLLGEPGEAFF	YLQPRTFLL	known
CASSSSGTATYEQYF	NQKLIANQF	known
CASSKEAGGPSGELFF	LTDEMIAQY	known
CASTRGAEGGSYNSPLHF	TTDPSFLGRY	known
CATSGDYGGSISDTQYF	TTDPSFLGRY	known
CASSLEWLGTTWDEQFF	TTDPSFLGRY	known
CASSFLAGGLKYNEQFF	NQKLIANQF	known
CASSIESGQLWELFF	TTDPSFLGRY	known
CASQGLNTGELFF	YLQPRTFLL	known
CASSDRAGTDTQYF	TTDPSFLGRY	known
CATQDTNTGELFF	YLQPRTFLL	known
CSGGTGGFYNEQFF	TTDPSFLGRY	known
CSVGKGWPYEQYF	LTDEMIAQY	known
CSVEAGYGYTF	FTSDYYQLY	known
CASRGPNSNQPQHF	RVAGDSGFAAY	known
CASSVEIQDEQYF	NQKLIANQF	known
CASSLQREYPYEQYF	TTDPSFLGRY	known
CASSLGGSSTDTQYF	FTSDYYQLY	known
CASSGGNTIYF	LTDEMIAQY	known
CASSQEGQQWGRDGYTF	TTDPSFLGRY	known
CASSEDHRVTGNTIYF	TTDPSFLGRY	known
CASSPSTGKVSTEAFF	LTDEMIAQY	known
CASSLSSQNNEKLFF	NQKLIANQF	known
CSVEPSGSYEQYF	VYFLQSINF	known
CASSYSLQPNQPQHF	RVAGDSGFAAY	known
CASSLEIEQYF	YLQPRTFLL	known
CAGQDSNTGELFF	YLQPRTFLL	known
CASSSRGRTSSYEQYF	TTDPSFLGRY	known
CASALAQAYEQYF	TTDPSFLGRY	known
CASSFGGTGPLGDTQYF	VYFLQSINF	known
CASSPSGSLEQYF	TTDPSFLGRY	known
CASNEQNSNEQFF	YLQPRTFLL	known
CASSPWTGQGYGYTF	FTSDYYQLY	known
CASSQTGTLYNEQFF	TTDPSFLGRY	known
CASSTQSTVNIQYF	ALSKGVHFV	known
CASSLASGQGPYEQYF	TTDPSFLGRY	known
CASSGTSGSTDTQYF	NQKLIANQF	known
CASTGPGGLAAGEQYF	LTDEMIAQY	known
CASSPDIEAFF	YLQPRTFLL	known
CSASDRRDEQFF	YLQPRTFLL	known
CASSVVLTSGPTDTQYF	LTDEMIAQY	known
CASSLGGTEAFF	LLYDANYFL	known
CASRTPAGANTEAFF	NQKLIANQF	known
CASTEGNTGELFF	YLQPRTFLL	known
CASSLVPGHNEQFF	TTDPSFLGRY	known
CASSQADRGGPNTGELFF	NQKLIANQF	known
CASSPGTSGGSSYNEQFF	NQKLIANQF	known
CASSPRDRVNTGELFF	LTDEMIAQY	known
CASSETGGYEQYF	NYNYLYRLF	known
CASSDRDSQQPQHF	TTDPSFLGRY	known
CASSEGQGYEQYF	NYNYLYRLF	known
CASSQGQGPPYEQYF	TTDPSFLGRY	known
CASSLLTSGGLRETQYF	FTSDYYQLY	known
CASSLGLNEQFF	TTDPSFLGRY	known
CASSQENRLAGISEQFF	NQKLIANQF	known
CASSEALSGGSETQYF	AEVQIDRLI	known
CSARDGVAHNTGELFF	YLQPRTFLL	known
CASSVAYEQYF	TTDPSFLGRY	known
CASSGSPGTGDYGYTF	YLQPRTFLL	known
CASSEIISGNYGYTF	TTDPSFLGRY	known
CASSETGGYEQYF	NYNYLYRLF	known
CASGDTNTGELFF	YLQPRTFLL	known
CASSLSAPKPFYNSPLHF	TTDPSFLGRY	known
CASRDTGELFF	VYFLQSINF	known
CSARDPRTGSSYEQYF	TTDPSFLGRY	known
CASSLGRGSNTQYF	TTDPSFLGRY	known
CAWSTGGTWTGELFF	LTDEMIAQY	known
CSAENYRLAGITDTQYF	NQKLIANQF	known
CASSFTGRRETQYF	LTDEMIAQY	known
CATSLRTDSYEQYF	FTSDYYQLY	known
CASSLGGSSTDTQYF	FTSDYYQLY	known
CASRSSPTQGTLTEAFF	RVAGDSGFAAY	known
CASSLQGVSYEQYF	TTDPSFLGRY	known
CASSEAPIGNTIYF	LTDEMIAQY	known
CASWTDDNQPQHF	TTDPSFLGRY	known
CASSPSGSFEQFF	LTDEMIAQY	known
CASSPGQRSYNEQFF	TTDPSFLGRY	known
CASSRPPGPSGSIFYNEQFF	FTSDYYQLY	known
CSVEEAGSYEQYF	TTDPSFLGRY	known
CASSPNQGLTQYEQYF	TTDPSFLGRY	known
CASSSLNTEAFF	TTDPSFLGRY	known
CASSFPGYPSGANVLTF	RVAGDSGFAAY	known
CASSLGQAYEQYF	TTDPSFLGRY	known
CASSPEIKAFF	YLQPRTFLL	known
CASSLGVGRAYEQYF	NQKLIANQF	known
CASSFENTGELFF	TTDPSFLGRY	known
CASQRGGREETQYF	YLQPRTFLL	known
CASSVVGTEAFF	RVAGDSGFAAY	known
CASSLPAASSYNEQFF	NQKLIANQF	known
CAWTRDRNTGELFF	YLQPRTFLL	known
CASSLSGYNEQFF	TTDPSFLGRY	known
CASSDLKGSTDTQYF	YLQPRTFLL	known
CASSFGDQPQHF	TTDPSFLGRY	known
CASSLSLSQGSFGYTF	YLQPRTFLL	known
CAWDRDHNTGELFF	YLQPRTFLL	known
CASRGRQGRWSSGANVLTF	YLQPRTFLL	known
CASSLAGGIVDEQFF	TTDPSFLGRY	known
CASSPGIPNYGYTF	LTDEMIAQY	known
CASSLTDSTDTQYF	TTDPSFLGRY	known
CASSLGDRGYQPQHF	RVAGDSGFAAY	known
CASSVYELSLPGAAQYF	TTDPSFLGRY	known
CSVRLAGGSGETQYF	TTDPSFLGRY	known
CATSPHQEGRTEAFF	LTDEMIAQY	known
CASSGGLGTDYEQYF	VYFLQSINF	known
CASSTRTEGTEAFF	YLQPRTFLL	known
CASTSGGTQHF	TTDPSFLGRY	known
CASSPTVSNTGELFF	LTDEMIAQY	known
CASGPGRGDINEQFF	NQKLIANQF	known
CASSSDPTAGYTF	TTDPSFLGRY	known
CATGQSNTGELFF	TTDPSFLGRY	known
CSVLTTGPGQPQHF	TTDPSFLGRY	known
CASSEQVTGDNEQFF	YLQPRTFLL	known
CAWGLAGGPIEQFF	LTDEMIAQY	known
CASGDSPLHF	TTDPSFLGRY	known
CASSLGGSNTDTQYF	FTSDYYQLY	known
CASSSVDNQPQHF	LLYDANYFL	known
CASGFDAGQGSYEQYF	TTDPSFLGRY	known
CSAIDRVDVYEQYF	PTDNYITTY	known
CAWEDRNTGELFF	YLQPRTFLL	known
CSVEQGTYEQYF	TTDPSFLGRY	known
CASSWTSGSYEQYF	TTDPSFLGRY	known
CASSSAALLSYEQYF	YLQPRTFLL	known
CASSQTAGYEQYF	NYNYLYRLF	known
CASIDDSLENYGYTF	TTDPSFLGRY	known
CASSPDIEQYF	YLQPRTFLL	known
CASSLPGARSGANVLTF	LTDEMIAQY	known
CASSLGGTEAFF	LLYDANYFL	known
CASSAPDRGNTEAFF	YLQPRTFLL	known
CSALPSTEANYGYTF	QELIRQGTDY	known
CASSGEGGPWGSLQFF	TTDPSFLGRY	known
CASTDDIEAFF	YLQPRTFLL	known
CSARDRELAGIEQFF	QYIKWPWYI	known
CASRPGTSGGYEQYF	AEVQIDRLI	known
CSAYYRTDYYGYTF	PTDNYITTY	known
CASSLILMGTSGGEQFF	TTDPSFLGRY	known
CASSFENTGELFF	TTDPSFLGRY	known
CASSQYRETSDTQYF	TTDPSFLGRY	known
CASSSTSRDYGYTF	NQKLIANQF	known
CASSLSSPQETQYF	TTDPSFLGRY	known
CASSEATGYEQYF	NYNYLYRLF	known
CASSPRTATYEQYF	YLQPRTFLL	known
CATLGTSGHNEQFF	YLQPRTFLL	known
CASRETGRAAGNTIYF	TTDPSFLGRY	known
CASSGTVTSSSTDTQYF	LTDEMIAQY	known
CASSQLGGYEQYF	NYNYLYRLF	known
CASSFKTDSYEQYF	PTDNYITTY	known
CASSVGAGELFF	ALSKGVHFV	known
CASSYGNQPQHF	YLQPRTFLL	known
CAWTNPISSDRGLGNTIYF	YLQPRTFLL	known
CASSEGEGYEQYF	NYNYLYRLF	known
CASSLGGQGDGSPLHF	FTSDYYQLY	known
CASSPLLAGGKNIQYF	NQKLIANQF	known
CASSLDGYTGELFF	TTDPSFLGRY	known
CASSLAQGYEQYF	NYNYLYRLF	known
CASREETGIRFYEQYF	YLQPRTFLL	known
CSARDGGTDTQYF	YLQPRTFLL	known
CASSLEDTNYGYTF	NQKLIANQF	known
CASSLSGLGETQYF	TTDPSFLGRY	known
CSANRAGKNIQYF	YLQPRTFLL	known
CASSFNRANTEAFF	VYFLQSINF	known
CASRLRGDSYEQYF	FTSDYYQLY	known
CASLRQNSGEQFF	YLQPRTFLL	known
CASSSSAESSYNEQFF	TTDPSFLGRY	known
CASSESSGGFFNEQFF	YLQPRTFLL	known
CASSEFPGPSDGYTF	YLQPRTFLL	known
CASSEAQGPQHF	LTDEMIAQY	known
CASSPDRGREKLFF	NQKLIANQF	known
CASSRTSAKLGEQYF	YLQPRTFLL	known
CASNPGHSNQPQHF	TTDPSFLGRY	known
CASRQGTLYGYTF	NQKLIANQF	known
CASSRLADGRNEQFF	YLQPRTFLL	known
CASSFFSWGTDNEQFF	QYIKWPWYI	known
CASSFQNGPSPQATQYF	PTDNYITTY	known
CASSVSYGYTF	TTDPSFLGRY	known
CASNEENTGELFF	YLQPRTFLL	known
CASSLSSPFWEQFF	TTDPSFLGRY	known
CASSETGGYEQYF	NYNYLYRLF	known
CASSLRDSGDTQYF	TTDPSFLGRY	known
CASSQQNQPQHF	TTDPSFLGRY	known
CASSSIYGTSYEQYF	YLQPRTFLL	known
CASRHFREVNTEAFF	YLQPRTFLL	known
CASDDPNTGELFF	YLQPRTFLL	known
CASSAEANTEAFF	ALSKGVHFV	known
CASVDRDWTWGTEAFF	LTDEMIAQY	known
CSVRGRTHNEQFF	TTDPSFLGRY	known
CASSRPEGEQYF	TTDPSFLGRY	known
CASGGTNTGELFF	YLQPRTFLL	known
CASSLYGGYEQYF	YLQPRTFLL	known
CAISEQGGNTEAFF	FTSDYYQLY	known
CASSLGEYTDTQYF	NQKLIANQF	known
CASSYLQGTQETQYF	LTDEMIAQY	known
CASSPVAGGNTGELFF	YLQPRTFLL	known
CASSPNQGPDTGELFF	VYFLQSINF	known
CASSLGGGSTDTQYF	FTSDYYQLY	known
CASSFQRSDTQYF	NQKLIANQF	known
CASSMAENTEAFF	VYFLQSINF	known
CASSQGSGNEQFF	QYIKWPWYI	known
CASSLTSGTEAFF	LLYDANYFL	known
CASVNPTGAKNIQYF	LTDEMIAQY	known
CASGQGFYEQYF	TTDPSFLGRY	known
CASSLRGGQDSGNTIYF	NQKLIANQF	known
CASSSLNTEAFF	VENPHLMGWD	known
CASSLLDRGFQPQHF	RVAGDSGFAAY	known
CASSLSSGGTYNEQFF	VYFLQSINF	known
CASSQVNRGFYNEQFF	RVAGDSGFAAY	known
CASSSTPNRGLAVGQYF	YLQPRTFLL	known
CASATGGGNTEAFF	DTDFVNEFY	known
CSASLGGITSSTDTQYF	YLQPRTFLL	known
CASEEGYSNQPQHF	TTDPSFLGRY	known
CASSQAVGSPLHF	VYFLQSINF	known
CSAHRDQNTGELFF	YLQPRTFLL	known
CASQDRNTGELFF	YLQPRTFLL	known
CASSPKTGRHQETQYF	TTDPSFLGRY	known
CASSKTPAEATGELFF	NTNSSPDDQIGYY	known
CASSFENTGELFF	TTDPSFLGRY	known
CASSPDIDKQYF	PTDNYITTY	known
CASSFEDTNYGYTF	NQKLIANQF	known
CASSESQGYEQYF	NYNYLYRLF	known
CASSYQDTRGLSPGELFF	FTSDYYQLY	known
CASSEAANQPQHF	LTDEMIAQY	known
CASTLDILGYTF	TTDPSFLGRY	known
CASSYRGSSLSSYEQYF	TTDPSFLGRY	known
CASSFNVNTEAFF	VYFLQSINF	known
CASSSRQGPKEYGYTF	LTDEMIAQY	known
CASSLAGNEQYF	TTDPSFLGRY	known
CASSSTTGLTREQYF	RVAGDSGFAAY	known
CASSSGTGAPEQYF	AEVQIDRLI	known
CAISESVRNSNQPQHF	YLQPRTFLL	known
CASTTEENRPYEQYF	LTDEMIAQY	known
CASSHDGYQPQHF	TTDPSFLGRY	known
CASSEWGATEAFF	TTDPSFLGRY	known
CATQDQNTGELFF	YLQPRTFLL	known
CAIRERQFCRYF	TTDPSFLGRY	known
CASQELDTGELFF	YLQPRTFLL	known
CASSPGSYSNQPQHF	NQKLIANQF	known
CASSWGGSSTDTQYF	FTSDYYQLY	known
CASRSSLGAYEEQYF	RVAGDSGFAAY	known
CASSEGTSGGISDTQYF	VYFLQSINF	known
CASSFTSSYNEQFF	NQKLIANQF	known
CASSPSARSSYEQYF	VYFLQSINF	known
CACAGFLHHTGELFF	TTDPSFLGRY	known
CASNPGGVETQYF	TTDPSFLGRY	known
CASSHRNTLEAFF	YLQPRTFLL	known
CASSYSRPTGHTEAFF	LTDEMIAQY	known
CASSQEDAGFSYNEQFF	TTDPSFLGRY	known
CASSHDIEAFF	YLQPRTFLL	known
CASSYPWDSQSSYNEQFF	YLQPRTFLL	known
CASSFTPGGQETQYF	TTDPSFLGRY	known
CASSLTGFGEQFF	PTDNYITTY	known
CASSLASNQPQHF	LTDEMIAQY	known
CATDSSSYEQYF	TTDPSFLGRY	known
CASSSRGPHGDEQFF	TTDPSFLGRY	known
CASSPRSGFDEQYF	TTDPSFLGRY	known
CAWSVGQGAREQYF	LTDEMIAQY	known
CASSFRDGGDTQYF	TTDPSFLGRY	known
CASSGTFGTSGNTDTQYF	RVAGDSGFAAY	known
CASSLEDTNYGYTF	NQKLIANQF	known
CASSLIGGSSGNTIYF	QYIKWPWYI	known
CATQSDPNTGELFF	YLQPRTFLL	known
CASSGGGGPDTQYF	PTDNYITTY	known
CASRQILYNEQFF	VYIGDPAQL	known
CATTEQGSLIEQYF	LTDEMIAQY	known
CASSQSGDSSYPQHF	QELIRQGTDY	known
CASSQDRVTGKYTF	NQKLIANQF	known
CASRGGYGYTF	PTDNYITTY	known
CAWSVAANTEAFF	QELIRQGTDY	known
CASSFTGNDDYEQYF	TTDPSFLGRY	known
CSGGTGGFYNEQFF	TTDPSFLGRY	known
CASSLAGSSYNSPLHF	YLQPRTFLL	known
CASSVAGSSYEQYF	LTDEMIAQY	known
CASSYRGTGLNEQFF	YLQPRTFLL	known
CASSIGQLHQETQYF	NQKLIANQF	known
CASSTGNQPQHF	AEVQIDRLI	known
CASSFRTSGNEQYF	TTDPSFLGRY	known
CASSLVTGEQYF	TTDPSFLGRY	known
CASSEGRGYEQYF	NYNYLYRLF	known
CASRGGQEYGYTF	NQKLIANQF	known
CASASELADTDTQYF	TTDPSFLGRY	known
CASSLPGRGETQYF	LTDEMIAQY	known
CASRDGQNQETQYF	QYIKWPWYI	known
CASSQRSAGAYEQYF	NQKLIANQF	known
CASSLLYGGGTDTQYF	TTDPSFLGRY	known
CARTGQVKAKNIQYF	LTDEMIAQY	known
CSVGPRQLMNTEAFF	LTDEMIAQY	known
CASSYRDGGDEQYF	TTDPSFLGRY	known
CASSHRNTLEAFF	YLQPRTFLL	known
CSVEGTESYEQYF	TTDPSFLGRY	known
CASSLGGGAYEQYF	DTDFVNEFY	known
CASSPEDRGAFF	NYNYLYRLF	known
CASSLAGASSYNEQFF	TTDPSFLGRY	known
CASSAFFESGELFF	TTDPSFLGRY	known
CATSPHQEGRTEAFF	LTDEMIAQY	known
CASSQDHYYNEQFF	YLQPRTFLL	known
CATSERGQGAHQETQYF	QYIKWPWYI	known
CASSLGGTEAFF	LLYDANYFL	known
CSVGTGWPYEQYF	LTDEMIAQY	known
CASSLDQDRAYTGELFF	TTDPSFLGRY	known
CASSLDIEAFF	YLQPRTFLL	known
CATGLANTGELFF	YLQPRTFLL	known
CASSWTSGSYEQYF	TTDPSFLGRY	known
CASSQDILARYNEQFF	YLQPRTFLL	known
CASSFLAGAVEQFF	TTDPSFLGRY	known
CASSEYLGELFF	LTDEMIAQY	known
CASSQDNYGGSPLHF	YLQPRTFLL	known
CASSLTQGFTEAFF	TTDPSFLGRY	known
CASSLDSPYEQYF	TTDPSFLGRY	known
CASTIMGRGGEAFF	NQKLIANQF	known
CSARDAAGQNTGELFF	YLQPRTFLL	known
CSVRGTLDSYNEQFF	LTDEMIAQY	known
CASTDLNTGELFF	FTSDYYQLY	known
CASSLSGGALDTQYF	NQKLIANQF	known
CASSLAIGDKVEQYF	LTDEMIAQY	known
CSARIARINAYEQYF	YLQPRTFLL	known
CSARTGANYGYTF	QELIRQGTDY	known
CASSLGGGGGTQPQHF	TTDPSFLGRY	known
CASSQDGGGNTEAFF	YLQPRTFLL	known
CASSQDGQGAMYEQYF	LTDEMIAQY	known
CASSLGIAKNIQYF	YLQPRTFLL	known
CASSAGTGFYGYTF	YLQPRTFLL	known
CASSLYESHNEQFF	TTDPSFLGRY	known
CASTLRDRGNQPQHF	YLQPRTFLL	known
CASSSERGLVREQYF	NYNYLYRLF	known
CASRSGQRNTEAFF	LTDEMIAQY	known
CASRAGGGDEQFF	VYIGDPAQL	known
CSVEGDLSGDEQFF	TTDPSFLGRY	known
CASSLDDGDRWGYTF	LTDEMIAQY	known
CAISEPGSNTEAFF	LTDEMIAQY	known
CASSEAQGYEQYF	NYNYLYRLF	known
CASSRHRGHFNEQFF	RVAGDSGFAAY	known
CAGQGMNTGELFF	YLQPRTFLL	known
CASSEAGGYEQYF	NYNYLYRLF	known
CASSQKLAGDNEQFF	ALSKGVHFV	known
CASSPRLAGSHNEQFF	YLQPRTFLL	known
CASSEKLPEFNQPQHF	TTDPSFLGRY	known
CASSHLGGPKETQYF	LTDEMIAQY	known
CASGEDSLVYGYTF	LTDEMIAQY	known
CSASGGSYGSYNEQFF	YLQPRTFLL	known
CASSLPDLQETQYF	TTDPSFLGRY	known
CASSQYRETSDTQYF	TTDPSFLGRY	known
CASSLTPTGSPLHF	QYIKWPWYI	known
CASSFRTDSYEQYF	PTDNYITTY	known
CASSFSLRGREPQHF	TTDPSFLGRY	known
CAIEDRNTGELFF	YLQPRTFLL	known
CASSYSRASGDDNEQFF	LTDEMIAQY	known
CASSYRLAGGVPHNEQFF	LTDEMIAQY	known
CASRPSGGWHEQFF	VYIGDPAQL	known
CASSSLTDTQYF	TTDPSFLGRY	known
CASSQDLRLAGVETQYF	NTNSSPDDQIGYY	known
CASSNNYEQYF	NYNYLYRLF	known
CASSLRLTDRATYEQYF	YLQPRTFLL	known
CASSPGTSNTGELFF	TTDPSFLGRY	known
CASTNWGLRQPQHF	YLQPRTFLL	known
CASSSTSGVTDTQYF	TTDPSFLGRY	known
CASSLDIKAFF	YLQPRTFLL	known
CAWGSMNTGELFF	YLQPRTFLL	known
CSVESSGSYEQYF	TTDPSFLGRY	known
CASSFGRGGSQPQHF	YLQPRTFLL	known
CASSLWGFGEETQYF	AEVQIDRLI	known
CASSFWGGGTEAFF	NQKLIANQF	known
CSVEKDRNTGELFF	YLQPRTFLL	known
CASSPRDRGFSPLHF	RVAGDSGFAAY	known
CASSAGEAGELFF	LTDEMIAQY	known
CASSYGGGQSTGELFF	TTDPSFLGRY	known
CASSLVEGINYGYTF	NQKLIANQF	known
CAIYGGPDGANTGELFF	TTDPSFLGRY	known
CASSLTSGSEQFF	YLQPRTFLL	known
CASSLGQSLEQYF	YLQPRTFLL	known
CASSPGEARGEQFF	YLQPRTFLL	known
CASSQDRLGDTQYF	VYFLQSINF	known
CASSLGGSNTDTQYF	FTSDYYQLY	known
CASSENRGYEQYF	NYNYLYRLF	known
CASSTARLGDTGELFF	TTDPSFLGRY	known
CGSGIQNTGELFF	YLQPRTFLL	known
CATTGGPEEKLFF	TTDPSFLGRY	known
CASSLTQGGVLFF	TTDPSFLGRY	known
CASSPGQGYEQYF	NYNYLYRLF	known
CASKERGYYNEQFF	YLQPRTFLL	known
CASSLLGARNEQFF	TTDPSFLGRY	known
CAWSGFANTGELFF	YLQPRTFLL	known
CASSERQQTYNEQFF	QYIKWPWYI	known
CASSIEWSGGQETQYF	TTDPSFLGRY	known
CASSQEGVGQGWSPLHF	YLQPRTFLL	known
CASSPTGEPNYGYTF	YLQPRTFLL	known
CASSPDRGGGYTF	YLQPRTFLL	known
CASSAGTGGYTF	TTDPSFLGRY	known
CASSPTPSGQGTADTQYF	YLQPRTFLL	known
CAISGGNEQFF	QYIKWPWYI	known
CASLGLAGELFF	TTDPSFLGRY	known
CASSLVVTGELFF	LTDEMIAQY	known
CATSRLPQHTTNEKLFF	NQKLIANQF	known
CASSLRDGGDTQYF	TTDPSFLGRY	known
CASSISGSGSDTQYF	YLQPRTFLL	known
CASSPRTGIDGYTF	RVAGDSGFAAY	known
CASSLEQGLPHAQYF	TTDPSFLGRY	known
CASSASLAGVNEQFF	ALSKGVHFV	known
CASSLSGPLETQYF	TTDPSFLGRY	known
CSVGQGWPYEQYF	LTDEMIAQY	known
CASSPSNYGYTF	QELIRQGTDY	known
CASSQDDGGTDEQYF	NQKLIANQF	known
CASGIAGPTDTQYF	TTDPSFLGRY	known
CASERRGLSGYTF	TTDPSFLGRY	known
CASSEAGGYEQFF	NYNYLYRLF	known
CASSTAGTSGRGELFF	YLQPRTFLL	known
CSARDTRLAGVEQFF	QYIKWPWYI	known
CASKHSGTGVLARELFF	VENPHLMGWD	known
CASIEGQGGGTDTQYF	ALSKGVHFV	known
CASSPSPKRGAYEQYF	YLQPRTFLL	known
CASSLMLGEETQYF	TTDPSFLGRY	known
CSARFPRSGNTIYF	QYIKWPWYI	known
CASSYTRLVQNTGELFF	LTDEMIAQY	known
CASSVGAGSNQPQHF	YLQPRTFLL	known
CASSKGGSNQPQHF	NQKLIANQF	known
CASSQGGNEQYF	YLQPRTFLL	known
CASSLYLGTTIRGEQFF	RVAGDSGFAAY	known
CASSVGFPGELFF	TTDPSFLGRY	known
CASSSWTGVGNEQYF	FTSDYYQLY	known
CASGLGSSYEQYF	TTDPSFLGRY	known
CASSPRDTLISGNTIYF	FTSDYYQLY	known
CASSSTRDRGQGYGYTF	RVAGDSGFAAY	known
CSARDSMAQNTGELFF	YLQPRTFLL	known
CASSSLARGALNYGYTF	RVAGDSGFAAY	known
CASRYPSGGYTF	TTDPSFLGRY	known
CASIGMYRNEQFF	LTDEMIAQY	known
CASMVRHANTGELFF	LTDEMIAQY	known
CASRSGTGTYEQYF	LTDEMIAQY	known
CASSLSGGNEKLFF	RVAGDSGFAAY	known
CASTRTVATNEKLFF	VYFLQSINF	known
CAISEEHTGEYQPQHF	LTDEMIAQY	known
CASSYWGGTDTQYF	LTDEMIAQY	known
CATSRAGQGHEQYF	TTDPSFLGRY	known
CASSFPSGGGEKLFF	FTSDYYQLY	known
CASSVAIERAPNYEQYF	ALSKGVHFV	known
CASSEGPGGDEQYF	YLQPRTFLL	known
CALNFTDTQYF	NTNSSPDDQIGYY	known
CASSQDGGQETQYF	VYFLQSINF	known
CASSLGPEAFF	YLQPRTFLL	known
CASSLEGIGGYTF	LTDEMIAQY	known
CAISESSGYEQYF	NYNYLYRLF	known
CSARDGDSISYNEQFF	TTDPSFLGRY	known
CASSLGQPAGEQFF	LTDEMIAQY	known
CASFEGGNSPLHF	VYFLQSINF	known
CASSYWGGTDTQYF	LTDEMIAQY	known
CAFGPRDRTNTGELFF	NQKLIANQF	known
CASSLKAPPHSNTEAFF	LTDEMIAQY	known
CASSSTSGRADTQYF	TTDPSFLGRY	known
CASSPRPDRELGNTIYF	RVAGDSGFAAY	known
CASSDQGANYEQYF	TTDPSFLGRY	known
CASSQDWARGTGSYEQYF	ALSKGVHFV	known
CASSPRGGGIYEQYF	ALSKGVHFV	known
CASRWAPGELFF	LTDEMIAQY	known
CSARILAGDTGELFF	TTDPSFLGRY	known
CASSQAGAKTQYF	RVAGDSGFAAY	known
CASSQDASGGPDIQYF	ALSKGVHFV	known
CAIRSGNTYSYEQYF	YLQPRTFLL	known
CASSLTDLYGYTF	LTDEMIAQY	known
CASSYHPEGGVSNQPQHF	FTSDYYQLY	known
CASSDPGARVWEQYF	TTDPSFLGRY	known
CASSQDRFGATAFF	VYIGDPAQL	known
CAIEDLNTGELFF	YLQPRTFLL	known
CSARDRSSYEQYF	YLQPRTFLL	known
CASSPDIEQFF	YLQPRTFLL	known
CASSQDGIAGYNEQFF	TTDPSFLGRY	known
CASSEAPGYEQYF	NYNYLYRLF	known
CASSILAGGGTDTQYF	YLQPRTFLL	known
CASSPTSGSYEQYF	VYFLQSINF	known
CASSLKVDGYNEQFF	TTDPSFLGRY	known
CASSPLGTYEQYF	TTDPSFLGRY	known
CASSSLSEGSGANVLTF	NQKLIANQF	known
CASSLGGGKISYNEQFF	YLQPRTFLL	known
CASSDLDTGELFF	YLQPRTFLL	known
CASSRDSGYSPLHF	LTDEMIAQY	known
CATLSGDIYNEQFF	TTDPSFLGRY	known
CASSIVPWDTQYF	ALSKGVHFV	known
CASSLAGGFTGELFF	YLQPRTFLL	known
CSVGGGPTYNEQFF	VYIGDPAQL	known
CASSEQTGSYGYTF	NYNYLYRLF	known
CASSETHSNQPQHF	TTDPSFLGRY	known
CASSPLSYEQYF	LTDEMIAQY	known
CASSPDIEAFF	YLQPRTFLL	known
CASSLGGTEAFF	LLYDANYFL	known
CASTGADTQYF	YLQPRTFLL	known
CASSRDRGEYNEQFF	TTDPSFLGRY	known
CASSPTPSGQGTADTQYF	YLQPRTFLL	known
CASSHRRLAGGLTSIQYF	VYFLQSINF	known
CASSLQGGNTEAFF	FTSDYYQLY	known
CASSVGGASLETQYF	FTSDYYQLY	known
CSALRDKNTGELFF	YLQPRTFLL	known
CATQRNQETQYF	LTDEMIAQY	known
CSARGEVEMNTGELFF	YLQPRTFLL	known
CSDGTGTNYGYTF	NQKLIANQF	known
CASSPETGAIDGYTF	NQKLIANQF	known
CASSRQGSQPQHF	LLYDANYFL	known
CASSWTQGAGYTF	TTDPSFLGRY	known
CASSLRDGYTDTQYF	TTDPSFLGRY	known
CASSPRDWYNEQFF	TTDPSFLGRY	known
CASSQDQAGGNTIYF	NQKLIANQF	known
CASSQGETQYF	QELIRQGTDY	known
CACTGRGGNGYTF	YLQPRTFLL	known
CASSYNPGNNEQFF	FTSDYYQLY	known
CASSVDRAQLFGYTF	TTDPSFLGRY	known
CATTGGPEEKLFF	TTDPSFLGRY	known
CASSLGGSSTDTQYF	FTSDYYQLY	known
CASSQVSGGARETQYF	RVAGDSGFAAY	known
CASSETGGYEQYF	NYNYLYRLF	known
CSARLAGGYEQYF	DTDFVNEFY	known
CASSLASSTAYGYTF	YLQPRTFLL	known
CASRIRGGPGTDTQYF	TTDPSFLGRY	known
CASSQDPRGRSSYEQYF	RVAGDSGFAAY	known
CSARDREGPNYEQYF	TTDPSFLGRY	known
CASSWTSGSYEQYF	TTDPSFLGRY	known
CASTQDSYGYTF	TTDPSFLGRY	known
CATCLGSSAGELFF	YLQPRTFLL	known
CASSFGGPPEAFF	QYIKWPWYI	known
CSARDQAKVLGTEAFF	QELIRQGTDY	known
CASSLWGAHTEAFF	TTDPSFLGRY	known
CASSLLQYNEQFF	PTDNYITTY	known
CASSYSSRRVYTGELFF	TTDPSFLGRY	known
CASSRLDEGQETQYF	FTSDYYQLY	known
CASSLSTSGRTLDTEAFF	LTDEMIAQY	known
CASSEFQSPYEQYF	NYNYLYRLF	known
CASSISHSTDTQYF	TTDPSFLGRY	known
CASSRGTSGRGINEQFF	LTDEMIAQY	known
CASSPQVGVANEKLFF	LTDEMIAQY	known
CASSLGLSGELFF	YLQPRTFLL	known
CSATRALGNEQFF	VYFLQSINF	known
CASSLPRANTGELFF	LTDEMIAQY	known
CASSFVSEEHNGYTF	TTDPSFLGRY	known
CASTTGTGYAEAFF	TTDPSFLGRY	known
CASYPHSNTGELFF	FTSDYYQLY	known
CASSGPGTGDGWAEAFF	FTSDYYQLY	known
CASSLSSPGNWEETQYF	FTSDYYQLY	known
CASSLLAGPNTGELFF	PTDNYITTY	known
CASSESTGYGYTF	YLQPRTFLL	known
CASSLGTKNIQYF	LTDEMIAQY	known
CASSLGDRGLLETQYF	VYFLQSINF	known
CATWDSDTGELFF	TTDPSFLGRY	known
CASNPGGGTETQYF	PTDNYITTY	known
CASAARQGSDEQYF	TTDPSFLGRY	known
CASSWTEGAYEQYF	TTDPSFLGRY	known
CSGIRLASGRSYEQYF	YLQPRTFLL	known
CASRPAPGTVTYGYTF	TTDPSFLGRY	known
CASSQSRDRVDF	TTDPSFLGRY	known
CASSEAQGPQYF	LTDEMIAQY	known
CASSQDLGSNQPQHF	LTDEMIAQY	known
CASSLTSAYEQYF	PTDNYITTY	known
CASRGREQYF	NTNSSPDDQIGYY	known
CASRWTDGIMNTEAFF	TTDPSFLGRY	known
CASSLGGNQPQHF	LTDEMIAQY	known
CASSESNSLEAFF	YLQPRTFLL	known
CSARGSSQWETQYF	YLQPRTFLL	known
CASSLRVAGEQFF	TTDPSFLGRY	known
CASSEGQGYEQYF	NYNYLYRLF	known
CSGKPRGGAIYEQYF	TTDPSFLGRY	known
CASTPGSEDTQYF	TTDPSFLGRY	known
CASSFAGTADYNSPLHF	TTDPSFLGRY	known
CASSLTGTGALYEQYF	LTDEMIAQY	known
CASSVEETSAGGHEQFF	TTDPSFLGRY	known
CATLTDANTGELFF	YLQPRTFLL	known
CAISESQEFYGYTF	YLQPRTFLL	known
CASSLDHPWGSPLHF	TTDPSFLGRY	known
CASSLEAGDYNEQFF	YLQPRTFLL	known
CASSLRSGLDTQYF	TTDPSFLGRY	known
CASSVGYRNTEAFF	YLQPRTFLL	known
CSVHQGWPYEQYF	LTDEMIAQY	known
CASSTSDPEAFF	NQKLIANQF	known
CASSLSPSTEAFF	NQKLIANQF	known
CASSLGDSYNEQFF	LTDEMIAQY	known
CAAGVNTGELFF	NQKLIANQF	known
CASSVGLAGATNEQFF	NQKLIANQF	known
CASSLYGQSDSPLHF	TTDPSFLGRY	known
CASSVDGGEFYEQYF	VYFLQSINF	known
CASSELIEFYEQYF	LTDEMIAQY	known
CASSVGRYTGELFF	AEVQIDRLI	known
CASSLAPGVSQTQYF	TTDPSFLGRY	known
CASSHRSGWETQYF	TTDPSFLGRY	known
CASSLSSDSYEQYF	PTDNYITTY	known
CAISGRQGDTGELFF	YLQPRTFLL	known
CSARSAASTDTQYF	YLQPRTFLL	known
CASSLGGAEAFF	LLYDANYFL	known
CAISEDVGQPQHF	PTDNYITTY	known
CASRTGQGATQYF	YLQPRTFLL	known
CASSLPGYYGYTF	YLQPRTFLL	known
CASSLASTDTQYF	YLQPRTFLL	known
CASSVAYRGNEQFF	YLQPRTFLL	known
CASSSSGPVNEQFF	TTDPSFLGRY	known
CASSPGAPGQGSYEQYF	YLQPRTFLL	known
CSARTDHNTGELFF	YLQPRTFLL	known
CASSQDTKRRAENTEAFF	NQKLIANQF	known
CSARDPGTGAYYGYTF	TTDPSFLGRY	known
CAISGDPTGVNNEQFF	YLQPRTFLL	known
CASSLAPHTSPMAYEQYF	NQKLIANQF	known
CASSILAGTYNEQFF	YLQPRTFLL	known
CASSLSGSPSPLHF	TTDPSFLGRY	known
CASSWTQGAYEQYF	TTDPSFLGRY	known
CASSFTSGSYEQYF	TTDPSFLGRY	known
CASSPLGGGNTGELFF	YLQPRTFLL	known
CASSLSQGSQYF	LTDEMIAQY	known
CASSFYPEGHEQYF	QYIKWPWYI	known
CASTNRGGITYEQYF	LTDEMIAQY	known
CASSEGLVYEQYF	TTDPSFLGRY	known
CSARGFRTGETGELFF	NQKLIANQF	known
CASSTEPLGSDIQYF	TTDPSFLGRY	known
CASSYGPPYEQYF	LTDEMIAQY	known
CASSPLSGLKEYF	TTDPSFLGRY	known
CASSYLAERDNEQFF	VYFLQSINF	known
CASSISHSTDTQYF	TTDPSFLGRY	known
CASSLSAGLDEQFF	TTDPSFLGRY	known
CASSRVWDTEAFF	AEVQIDRLI	known
CASSPDIGAFF	YLQPRTFLL	known
CSVEDRNSYEQYF	TTDPSFLGRY	known
CASSPGGTEAFF	DTDFVNEFY	known
CASSEDRGSYGYTF	TTDPSFLGRY	known
CASSPTGDYNSPLHF	NQKLIANQF	known
CASRRDRAYEQYF	NQKLIANQF	known
CASSEGQGYEQYF	NYNYLYRLF	known
CSVLTGWPYEQYF	LTDEMIAQY	known
CASSSGSNYEQYF	PTDNYITTY	known
CASTWGTDYNEQFF	TTDPSFLGRY	known
CSASTDRELNEQYF	YLQPRTFLL	known
CASSQVPGTGYEQYF	FTSDYYQLY	known
CASSVGGSEKNTEAFF	YLQPRTFLL	known
CASSMPNANTGELFF	LTDEMIAQY	known
CASSGGALSEQYF	YLQPRTFLL	known
CSADDYSGSSDEQFF	NQKLIANQF	known
CASARRTSGEDTQYF	AALALLLLDRLNQLE	known
CASSLGRMNTEAFF	AALALLLLDRLNQLE	known
CASSPRTLTVPRGTDTQYF	AALALLLLDRLNQLE	known
CASSLTGGMGYTF	NCTFEYVSQPFLMDL	known
CASSPRERVNTGELFF	NCTFEYVSQPFLMDL	known
CASSIGTSGGPNTGELFF	NCTFEYVSQPFLMDL	known
CASSKGTSGGPNTGELFF	NCTFEYVSQPFLMDL	known
CASSTRGHNTGELFF	NCTFEYVSQPFLMDL	known
CASTRGSSGGPNTGELFF	NCTFEYVSQPFLMDL	known
CASSPRDRANTGELFF	NCTFEYVSQPFLMDL	known
CASSVRDRPNTGELFF	NCTFEYVSQPFLMDL	known
CASSVRDRVNTGELFF	NCTFEYVSQPFLMDL	known
CASSLRGANGYTF	NCTFEYVSQPFLMDL	known
CASSQGVGYTF	NCTFEYVSQPFLMDL	known
CASSPGQGAIYGYTF	NCTFEYVSQPFLMDL	known
CASSLARQGWGGNEKLFF	NCTFEYVSQPFLMDL	known
CASSPRGDGYTF	NCTFEYVSQPFLMDL	known
CASSIQGSGNTIYF	NCTFEYVSQPFLMDL	known
CASSYSQGQPQHF	NCTFEYVSQPFLMDL	known
CASSYIHRSNTEAFF	RISNCVADYSVLYNS	known
CSATRQVNQPQHF	RISNCVADYSVLYNS	known
CASSLQGGGNQPQHF	RISNCVADYSVLYNS	known
CASSRQGGGDQPQHF	RISNCVADYSVLYNS	known
CASSYVSAGVNEKLFF	RISNCVADYSVLYNS	known
CASSPHPGAAGNTIYF	RISNCVADYSVLYNS	known
CASSPGAETQYF	RISNCVADYSVLYNS	known
CSASGSGSTYNEQFF	VGGNYNYLYRLFRKS	known
CASSLQQGAGTDTQYF	VGGNYNYLYRLFRKS	known
CASSGLVGAGSSYNSPLHF	VGGNYNYLYRLFRKS	known
CAWSEGQGVGQPQHF	VGGNYNYLYRLFRKS	known
CAWRRMNTEAFF	VGGNYNYLYRLFRKS	known
CAWSGPAGSMSGELFF	VGGNYNYLYRLFRKS	known
CAISDPGGRSNEQFF	VGGNYNYLYRLFRKS	known
CASSVDSSSGNTIYF	VGGNYNYLYRLFRKS	known
CASSLVGGNPSTTTYEQYF	VGGNYNYLYRLFRKS	known
CASSLSGGNNEQFF	VGGNYNYLYRLFRKS	known
CASSPGNVASGRYQETQYF	NNSYECDIPIGAGIC	known
CASSQDSGGQGFYEQYF	NNSYECDIPIGAGIC	known
CASSRRQGGVTEAFF	NNSYECDIPIGAGIC	known
CASSGLVGAGSSYNSPLHF	NNSYECDIPIGAGIC	known
CASSVDPNTEAFF	NNSYECDIPIGAGIC	known
CASRWTSGGADTQYF	NFSQILPDPSKPSKR	known
CASKDRANYNSPLHF	NFSQILPDPSKPSKR	known
CASSLGERGSYEQFF	NFSQILPDPSKPSKR	known
CASSLESEGEQYF	NFSQILPDPSKPSKR	known
CASSLEGLHSGNTIYF	NFSQILPDPSKPSKR	known
CASSLDRQAEAFF	NFSQILPDPSKPSKR	known
CAISESTSGGRQETQYF	HWFVTQRNFYEPQII	known
CAISESRTSGQETQYF	HWFVTQRNFYEPQII	known
CATSSYRGKNEKLFF	HWFVTQRNFYEPQII	known
CASSSGEGGETQYF	HWFVTQRNFYEPQII	known
CASSLQGGGNQPQHF	HWFVTQRNFYEPQII	known
CSARDSEVNTEAFF	HWFVTQRNFYEPQII	known
CASSSDLQGGGNTIYF	HWFVTQRNFYEPQII	known
CSPRDPLNNEQFF	HWFVTQRNFYEPQII	known
CASSSVTGPGAQYF	HWFVTQRNFYEPQII	known
CASSRQGRTDTQYF	HWFVTQRNFYEPQII	known
CSARDRVRNEQYF	HWFVTQRNFYEPQII	known
CASRPLQGSHGYTF	HWFVTQRNFYEPQII	known
CASSSRAEANEQFF	HWFVTQRNFYEPQII	known
CASSYPTGRSTNTGELFF	HWFVTQRNFYEPQII	known
CASSLVSGWDTDTQYF	HWFVTQRNFYEPQII	known
CASSRAGGASTDTQYF	HWFVTQRNFYEPQII	known
CASSRAGTGYNEQFF	KTFPPTEPK	known
CASSPSVYFEVSGANVLTF	KTFPPTEPK	known
CSARDEKATNTGELFF	YLQPRTFLL	known
CASMEENTGELFF	YLQPRTFLL	known
CASSPGTTLAKNIQYF	YLQPRTFLL	known
CASIRDHNTGELFF	YLQPRTFLL	known
CATQTANTGELFF	YLQPRTFLL	known
CASSELNTGELFF	YLQPRTFLL	known
CATQTANTGELFF	YLQPRTFLL	known
CAAGDANTGELFF	YLQPRTFLL	known
CASSPDIEQYF	YLQPRTFLL	known
CASSDLNTGELFF	YLQPRTFLL	known
CALGEQNTGELFF	YLQPRTFLL	known
CASPNQNTGELFF	YLQPRTFLL	known
CASSDLNTGELFF	YLQPRTFLL	known
CASSDLNTGELFF	YLQPRTFLL	known
CASSEIDTGELFF	YLQPRTFLL	known
CSARGKREHNTGELFF	YLQPRTFLL	known
CASSPTGGGNTGELFF	YLQPRTFLL	known
CSARGLAEANTGELFF	YLQPRTFLL	known
CATQDANTGELFF	YLQPRTFLL	known
CASSPDRNTGELFF	YLQPRTFLL	known
CARGLANTGELFF	YLQPRTFLL	known
CASSLDIEAFF	YLQPRTFLL	known
CASSFDIAEFF	YLQPRTFLL	known
CAGGEPNTGELFF	YLQPRTFLL	known
CASSEENTGELFF	YLQPRTFLL	known
CSAGDLNTGELFF	YLQPRTFLL	known
CSARDPSGVKLFF	YLQPRTFLL	known
CASSYPTGEGQETQYF	YLQPRTFLL	known
CASQTLNTGELFF	YLQPRTFLL	known
CASTRDLNTGELFF	YLQPRTFLL	known
CASSLETAGEQYF	YLQPRTFLL	known
CATTSLNTGELFF	YLQPRTFLL	known
CASENRNTGELFF	YLQPRTFLL	known
CASGQLNTGELFF	YLQPRTFLL	known
CASSAGVSGEQYF	YLQPRTFLL	known
CASSFARAQADTQYF	YLQPRTFLL	known
CASRDGRESYEQYF	YLQPRTFLL	known
CAGQVTNTGELFF	YLQPRTFLL	known
CASQDTNTGELFF	YLQPRTFLL	known
CASSDRGRSYEQYF	YLQPRTFLL	known
CASNNANTGELFF	YLQPRTFLL	known
CASSLDIEQYF	YLQPRTFLL	known
CASSVEPGWDEQYF	YLQPRTFLL	known
CASINLNTGELFF	YLQPRTFLL	known
CALGDLNTGELFF	YLQPRTFLL	known
CASGKQNTGELFF	YLQPRTFLL	known
CAAGQGNTGELFF	YLQPRTFLL	known
CASINLNTGELFF	YLQPRTFLL	known
CASTLAGTGEEKLFF	YLQPRTFLL	known
CASSFPGGGNTGELFF	YLQPRTFLL	known
CASGQLNTGELFF	YLQPRTFLL	known
CASNDLNTGELFF	YLQPRTFLL	known
CAVEGNLNTGELFF	YLQPRTFLL	known
CSARDPRAQNTGELFF	YLQPRTFLL	known
CSARGGQGLNTGELFF	YLQPRTFLL	known
CSAPSYGELFF	YLQPRTFLL	known
CSVEADRNTGELFF	YLQPRTFLL	known
CSVDRGSPSYEQYF	YLQPRTFLL	known
CASSQTESTDTQYF	YLQPRTFLL	known
CAIIDRNTGELFF	YLQPRTFLL	known
CASSTPLENEQFF	YLQPRTFLL	known
CASSLDIEQYF	YLQPRTFLL	known
CASSPDIVAFF	YLQPRTFLL	known
CARGDANTGELFF	YLQPRTFLL	known
CASSVTANTGELFF	SPRWYFYYL	known
CASRQLAGFYEQYF	SPRWYFYYL	known
CASSVEGTVNSPLHF	SPRWYFYYL	known
CASSLGRAVIWGYTF	SPRWYFYYL	known
CASSSLTSGAHNEQFF	SPRWYFYYL	known
CASSVSGGAYNEQFF	SPRWYFYYL	known
CASSQDGPRGQETQYF	SPRWYFYYL	known
CASSGLTDANTEAFF	SPRWYFYYL	known
CASSISGGYNEQFF	SPRWYFYYL	known
CASSTIAGETKNIQYF	SPRWYFYYL	known
CASRLANTEAFF	SPRWYFYYL	known
CASSPMGHEQYF	SPRWYFYYL	known
CSARGGFRSGGGTDEQFF	SPRWYFYYL	known
CASSEEIAKNIQYF	SPRWYFYYL	known
CSARAGIREGFYNEQFF	SPRWYFYYL	known
CSATDRANVNQPQHF	SPRWYFYYL	known
CASSFLTSANTGELFF	SPRWYFYYL	known
CATSDLTGANEQFF	SPRWYFYYL	known
CASSQDLASSTDTQYF	SPRWYFYYL	known
CASSPPTGNEQFF	SPRWYFYYL	known
CATSPLAGEYSGELFF	SPRWYFYYL	known
CASSPIAGGPISKNIQYF	SPRWYFYYL	known
CASSPDRALPEAFF	SPRWYFYYL	known
CSVDALLGAYTQYF	SPRWYFYYL	known
CSATDRAASYNSPLHF	SPRWYFYYL	known
CASSTLGTADKLNYGYTF	SPRWYFYYL	known
CASSSLTGQSQETQYF	SPRWYFYYL	known
CSARDRTDSYNSPLHF	SPRWYFYYL	known
CASSGLTSAKNEQFF	SPRWYFYYL	known
CATSDLVSDTQYF	SPRWYFYYL	known
CASWTGAAEAFF	SPRWYFYYL	known
CASSQTYPGAYNEQFF	SPRWYFYYL	known
CATSDPTDRVDGYTF	SPRWYFYYL	known
CASSLATGSGNQPQHF	SPRWYFYYL	known
CASSLGVAGTDTQYF	SPRWYFYYL	known
CASVGLAVVGELFF	SPRWYFYYL	known
CATSGTGTSGRNEQFF	SPRWYFYYL	known
CASTPLGTSSFLNTEAFF	SPRWYFYYL	known
CASRALTGHPDAKNIQYF	SPRWYFYYL	known
CASSPGTSGRPYEQYF	SPRWYFYYL	known
CASRGGGQGGSYGYTF	SPRWYFYYL	known
CSVVPLMGGYEQYF	SPRWYFYYL	known
CASSSKPGGDYNEQFF	SPRWYFYYL	known
CASNPLAGEFTAKNIQYF	SPRWYFYYL	known
CASSAGLAGANTGELFF	SPRWYFYYL	known
CSVQGRGELFF	SPRWYFYYL	known
CASSDIFLAKNIQYF	SPRWYFYYL	known
CASSDRTGRRNEQYF	SPRWYFYYL	known
SPAVHRVANNEQLF	SPRWYFYYL	known
CASSQSGTGPYEQYF	SPRWYFYYL	known
CASSPSSREQYF	SPRWYFYYL	known
CASSGLNDRFYEQYF	SPRWYFYYL	known
CASSLFRGGEKLFF	SPRWYFYYL	known
CASRGQRNTIYF	SPRWYFYYL	known
CASSRLAGGRNEQFF	SPRWYFYYL	known
CASSSFPGREMTF	SPRWYFYYL	known
CASAALAAYNEQFF	SPRWYFYYL	known
CSARRGLNEQFF	SPRWYFYYL	known
CARRQGNEKLFF	SPRWYFYYL	known
CASSARDF	SPRWYFYYL	known
CASGSGGEHF	SPRWYFYYL	known
CASSLGTGAQETQYF	SPRWYFYYL	known
CASSQVRGPQFF	SPRWYFYYL	known
CASRTPGTSGGSYEQYF	SPRWYFYYL	known
CATSRRTVLRETQYF	SPRWYFYYL	known
CASSRLAGGNTGELFF	SPRWYFYYL	known
CASSQPAGYGGYTF	SPRWYFYYL	known
CASQPLAGGPNEQFF	SPRWYFYYL	known
CASSGLAGGYNEQFF	SPRWYFYYL	known
CASSELDGRL	SPRWYFYYL	known
CASSPGDTQYF	SPRWYFYYL	known
CASSHNGELFF	SPRWYFYYL	known
CASSLNRELFF	SPRWYFYYL	known
CASSLLLRDGGRGAFF	SPRWYFYYL	known
CSVSGQKEETQYF	SPRWYFYYL	known
CSVVGTGGPETQYF	SPRWYFYYL	known
CASSSGGYEQYF	SPRWYFYYL	known
CASSPLSGTSATKETQYF	SPRWYFYYL	known
CSVVPLAGPYEQYF	SPRWYFYYL	known
CASSRRWGSSYEQYF	SPRWYFYYL	known
CASSPTDNF	SPRWYFYYL	known
CASSPTDNF	SPRWYFYYL	known
CASSESQGYEQYF	NYNYLYRLF	known
CASSEGQGYEQFF	NYNYLYRLF	known
CASSETGGYEQYF	NYNYLYRLF	known
CASSLASGYEQYF	NYNYLYRLF	known
CAWSVTGVTEAFF	NYNYLYRLF	known
CASSEGQGYEQYF	NYNYLYRLF	known
CASASGQGYEQYF	NYNYLYRLF	known
CASSQSGGGEQFF	QYIKWPWYI	known
CASCPSWGSGANVLTF	QYIKWPWYI	known
CASSLVGEGRGREQYF	QYIKWPWYI	known
CSARDQDRAYEQYF	QYIKWPWYI	known
CASSLSTTTASYEQYF	QYIKWPWYI	known
CASTPWGAEAFF	QYIKWPWYI	known
CSVDPGQFYNEQFF	QYIKWPWYI	known
CASSLGETIYGYTF	QYIKWPWYI	known
CAGKSTGELFF	QYIKWPWYI	known
CASSWNGLAGDEQFF	QYIKWPWYI	known
CASSALVAFSTDTQYF	QYIKWPWYI	known
CASSSLAGEVNEQFF	QYIKWPWYI	known
CASSSYTQRGLDYTGELFF	QYIKWPWYI	known
CASSQDYWGGGADTQYF	QYIKWPWYI	known
CASSPSMSTGELFF	YLQPRTFLL	known
CSARDHVGQNTGELFF	YLQPRTFLL	known
CASSFGISGELFF	YLQPRTFLL	known
CATSPDPNTGELFF	YLQPRTFLL	known
CATQDANTGELFF	YLQPRTFLL	known
CSVTPDMNTGELFF	YLQPRTFLL	known
CASSPRQGKDNEQFF	YLQPRTFLL	known
CASSPGLTDTQYF	YLQPRTFLL	known
CASSPEVEAFF	YLQPRTFLL	known
CASSLGYEQYF	YLQPRTFLL	known
CASSDLNTGELFF	YLQPRTFLL	known
CSVDLGHPEAFF	YLQPRTFLL	known
CATLDRNTGELFF	YLQPRTFLL	known
CATSDLNTGELFF	YLQPRTFLL	known
CASSSDIEQYF	YLQPRTFLL	known
CASSLGYEQYF	YLQPRTFLL	known
CASSQGASGFQETQYF	YLQPRTFLL	known
CASSPLGGGNTGELFF	YLQPRTFLL	known
CASSDPRDSSTDTQYF	YLQPRTFLL	known
CASSSDIEAFF	YLQPRTFLL	known
CASSQDRNTGELFF	YLQPRTFLL	known
CASSLSGTEQFF	YLQPRTFLL	known
CATSDLAGTSTDTQYF	YLQPRTFLL	known
CATQVVNTGELFF	YLQPRTFLL	known
CASSSDRDQPQHF	YLQPRTFLL	known
CASTSRQVHEKLFF	YLQPRTFLL	known
CSAKDRGSQETQYF	YLQPRTFLL	known
CASSSNYEQYF	YLQPRTFLL	known
CASSVGGYTEAFF	YLQPRTFLL	known
CAITPGTSGGEQFF	YLQPRTFLL	known
CASSPDIGLFF	YLQPRTFLL	known
CASGTANTGELFF	YLQPRTFLL	known
CASSDMNTGELFF	YLQPRTFLL	known
CASGGTNTGELFF	YLQPRTFLL	known
CAIFSSGLDEQFF	YLQPRTFLL	known
CASGTLNTGELFF	YLQPRTFLL	known
CSARDRGATNTGELFF	YLQPRTFLL	known
CASSFGEGALGAEAFF	YLQPRTFLL	known
CAREASGAGELFF	YLQPRTFLL	known
CADQDLNTGELFF	YLQPRTFLL	known
CASSHGVGQGPYEQYF	YLQPRTFLL	known
CARGQENTGELFF	YLQPRTFLL	known
CASSPSGTSTGELFF	YLQPRTFLL	known
CATQGLNTGELFF	YLQPRTFLL	known
CSVARLAGASPYNEQFF	YLQPRTFLL	known
CASSLWTGSEAFF	YLQPRTFLL	known
CASSYQQGPEAFF	YLQPRTFLL	known
CASSPDPRADTQYF	YLQPRTFLL	known
CASSLGQSYEQYF	YLQPRTFLL	known
CASSQDRGGYTEAFF	YLQPRTFLL	known
CSARDGGMGAFGYTF	YLQPRTFLL	known
CASSLIRGAAFF	YLQPRTFLL	known
CAGGDTNTGELFF	YLQPRTFLL	known
CATEDRNTGELFF	YLQPRTFLL	known
CASADMNTGELFF	YLQPRTFLL	known
CASSPDPNTGELFF	YLQPRTFLL	known
CASNEVNTGELFF	YLQPRTFLL	known
CSAFQDRNTGELFF	YLQPRTFLL	known
CAINKDRNTGELFF	YLQPRTFLL	known
CAWSVVGMGETQYF	YLQPRTFLL	known
CASFVNPNTGELFF	YLQPRTFLL	known
CAGQLANTGELFF	YLQPRTFLL	known
CASQTANTGELFF	YLQPRTFLL	known
CASSDLNSGELFF	YLQPRTFLL	known
CATCSDVNTGELFF	YLQPRTFLL	known
CATGQPNTGELFF	YLQPRTFLL	known
CASSFVRASTEAFF	YLQPRTFLL	known
CASSLDRDGNTGELFF	YLQPRTFLL	known
CAWVERNTGELFF	YLQPRTFLL	known
CSARDREQQNTGELFF	YLQPRTFLL	known
CASMKEMNTGELFF	YLQPRTFLL	known
CATCRVNTGELFF	YLQPRTFLL	known
CASSYMNTGELFF	YLQPRTFLL	known
CAAYDSNTGELFF	YLQPRTFLL	known
CASQRVNTGELFF	YLQPRTFLL	known
CSAHRDLNTGELFF	YLQPRTFLL	known
CASRRTSGGPNNEQFF	YLQPRTFLL	known
CAATGNVNTGELFF	YLQPRTFLL	known
CASGDQNTGELFF	YLQPRTFLL	known
CASYLTGFIDEQYF	YLQPRTFLL	known
CASSDVAGRNTGELFF	YLQPRTFLL	known
CSARDRLAENTGELFF	YLQPRTFLL	known
CASSDGDSGEAFF	YLQPRTFLL	known
CAIQDRGSLNTGELFF	YLQPRTFLL	known
CASRGREELNTGELFF	YLQPRTFLL	known
CASSPPAGGNTGELFF	YLQPRTFLL	known
CADGSANTGELFF	YLQPRTFLL	known
CATGPGQGDYGYTF	YLQPRTFLL	known
CASQDANTGELFF	YLQPRTFLL	known
CASSSLNTGELFF	YLQPRTFLL	known
CSVPRDQNTGELFF	YLQPRTFLL	known
CAGLIMNTGELFF	YLQPRTFLL	known
CASSVWDSEQETQYF	YLQPRTFLL	known
CASSLDRNTGELFF	YLQPRTFLL	known
CASTERNTGELFF	YLQPRTFLL	known
CATLRDLNTGELFF	YLQPRTFLL	known
CASSLANTGELFF	YLQPRTFLL	known
CASQRKNTGELFF	YLQPRTFLL	known
CASQDRNTGELFF	YLQPRTFLL	known
CSARWGQMQNTGELFF	YLQPRTFLL	known
CASSLDVEQYF	YLQPRTFLL	known
CASSPDSEQYF	YLQPRTFLL	known
CSARDAAATNTGELFF	YLQPRTFLL	known
CAISPDGNTGELFF	YLQPRTFLL	known
CASSEMNTGELFF	YLQPRTFLL	known
CASSVNRDGGYTF	YLQPRTFLL	known
CASSPMMDEQFF	YLQPRTFLL	known
CATSRPATEAFF	YLQPRTFLL	known
CATSPGQGTYGYTF	YLQPRTFLL	known
CASSEWDGYEQYF	YLQPRTFLL	known
CASSASLSPDMAYTGELFF	YLQPRTFLL	known
CASSELAGGNTGELFF	YLQPRTFLL	known
CASLFGGHEQFF	YLQPRTFLL	known
CASSSRIYGELFF	YLQPRTFLL	known
CANPDRNTGELFF	YLQPRTFLL	known
CASRHMGTGFYNEQFF	YLQPRTFLL	known
CASSSANSGELFF	YLQPRTFLL	known
CATTELDTGELFF	YLQPRTFLL	known
CASRGLAEMNTGELFF	YLQPRTFLL	known
CSVKNGTRWTQYF	YLQPRTFLL	known
CASSPPAWSGEQYF	YLQPRTFLL	known
CAWQTLNTGELFF	YLQPRTFLL	known
CASSSSVNEQFF	RLQSLQTYV	known
CASSPRDREESEQYF	RLQSLQTYV	known
CASSLSSTGDGYTF	RLQSLQTYV	known
CATSVQGQTGELFF	RLQSLQTYV	known
CASSLAQGTYNEQFF	RLQSLQTYV	known
CSARVAGGPGEQYF	RLQSLQTYV	known
CASSPLPGTGPGNEQFF	RLQSLQTYV	known
CASSLRSGRVQETQYF	RLQSLQTYV	known
CASTRGESYEQYF	RLQSLQTYV	known
CASKGEGLGEQYF	RLQSLQTYV	known
CASSTLAGSTDTQYF	RLQSLQTYV	known
CASSSGQGNNSPLHF	RLQSLQTYV	known
CASSPLPGT	RLQSLQTYV	known
CASSIDERAQPQHF	RLQSLQTYV	known
CASSGENTEAFF	RLQSLQTYV	known
CASSEAKSDAYEQYF	RLQSLQTYV	known
CASSPPGPSLNEQFF	RLQSLQTYV	known
CASSPSGDIQYF	RLQSLQTYV	known
CASSFPGKHGYTF	RLQSLQTYV	known
CASSFPDTHEQYF	RLQSLQTYV	known
CASSSPGQEAEQYF	RLQSLQTYV	known
CASSTTGEANEKLFF	RLQSLQTYV	known
CASSPRGQGGTGELFF	RLQSLQTYV	known
CASSLENRPTYEQYF	RLQSLQTYV	known
CASSNSGSRIDGYTF	RLQSLQTYV	known
CASSQAVGGTNTDTQYF	RLQSLQTYV	known
CSASEGRNTEAFF	RLQSLQTYV	known
CASSPMMDEQFF	RLQSLQTYV	known
CATSRPATEAFF	RLQSLQTYV	known
CASSGEGGHSNQPQHF	RLQSLQTYV	known
CAFLGGSGANVLTF	RLQSLQTYV	known
CASSHVSPNTGELFF	RLQSLQTYV	known
CASSLMGSNGELFF	RLQSLQTYV	known
CANPDRNTGELFF	RLQSLQTYV	known
CASSLLDRNTEAFF	RLQSLQTYV	known
CASSIVEGASYEQYF	RLQSLQTYV	known
CASMGEGAKNIQYF	RLQSLQTYV	known
CASSQGQGGTNEKLFF	RLQSLQTYV	known
CASSWINQPQHF	RLQSLQTYV	known
CAISVGREGSGANVLTF	RLQSLQTYV	known
CASSPGSRVEQFF	RLQSLQTYV	known
CASSPRTQAKNIQYF	RLQSLQTYV	known
CASSFGGGPTYEQYF	RLQSLQTYV	known
CASSSNRDRPYEQYF	RLQSLQTYV	known
CASSMEGGETQYF	RLQSLQTYV	known
CASSSANSGELFF	RLQSLQTYV	known
CASSSLSGGAGNTIYF	RLQSLQTYV	known
CASTPTGTSGTGELFF	RLQSLQTYV	known
CASRDLGQVNTGELFF	RLQSLQTYV	known
CAIWDFGGSTDTQYF	RLQSLQTYV	known
CASSRDGSYEQYF	RLQSLQTYV	known
CASSPPGSYNEQFF	RLQSLQTYV	known
CASSQDRVGDTGELFF	RLQSLQTYV	known
CASSWGGAYEQYF	RLQSLQTYV	known
CASSFQNTGELFF	YLQPRTFLL	known
CASSSVNNNEQFF	YLQPRTFLL	known
CAVGEANTGELFF	YLQPRTFLL	known
CAYQEVNTGELFF	YLQPRTFLL	known
CSARDDQAVNTGELFF	YLQPRTFLL	known
CSAGQRNTGELFF	YLQPRTFLL	known
CASSLEIEAFF	YLQPRTFLL	known
CAGDYLNTGELFF	YLQPRTFLL	known
CASSPDIACTF	YLQPRTFLL	known
CASSVDNTGELFF	YLQPRTFLL	known
CASSPDIEAFF	YLQPRTFLL	known
CAGQDLNTGELFF	YLQPRTFLL	known
CASSPDIVAFF	YLQPRTFLL	known
CAAQNLNTGELFF	YLQPRTFLL	known
CASSLDIEAFF	YLQPRTFLL	known
CSAGDRNTGELFF	YLQPRTFLL	known
CSARGGQGQNTGELFF	YLQPRTFLL	known
CASSPDIEQYF	YLQPRTFLL	known
CASTDLNTGELFF	YLQPRTFLL	known
CASSELNTGELFF	YLQPRTFLL	known
CATQDVNTGELFF	YLQPRTFLL	known
CASSDLSTGELFF	YLQPRTFLL	known
CASSDLNSGEQYF	YLQPRTFLL	known
CASRGEQGYQETQYF	RLQSLQTYV	known
CASTWGRASTDTQYF	RLQSLQTYV	known
CASSQDLQGTNEKLFF	RLQSLQTYV	known
CANQDSNTGELFF	YLQPRTFLL	known
CASGDLSSGEQYF	YLQPRTFLL	known
CASSDQNGNIQYF	YLQPRTFLL	known
CASTELNGGTQYF	YLQPRTFLL	known
CASGTANTGELFF	YLQPRTFLL	known
CATSGAETHNTGELFF	YLQPRTFLL	known
CATLVDLNTGELFF	YLQPRTFLL	known
CAYLEANSYEQYF	YLQPRTFLL	known
CASQDLNTGELFF	YLQPRTFLL	known
CASQDLNTGELFF	YLQPRTFLL	known
CASQEANTGELFF	YLQPRTFLL	known
CSARDGPGVNTGELFF	YLQPRTFLL	known
CATEDLNTGELFF	YLQPRTFLL	known
CASSTDIEAFF	YLQPRTFLL	known
CATSEENTGELFF	YLQPRTFLL	known
CALGEPNTGELFF	YLQPRTFLL	known
CASSSLNTGELFF	YLQPRTFLL	known
CASSELGGGNTGELFF	YLQPRTFLL	known
CSARDWEQMNTGELFF	YLQPRTFLL	known
CASSPVGGGNTGELFF	YLQPRTFLL	known
CASTPLNTGELFF	YLQPRTFLL	known
CSARDQPGQNTGELFF	YLQPRTFLL	known
CASSQTESTDTQYF	YLQPRTFLL	known
CALFRDRNTGELFF	YLQPRTFLL	known
CASSNSLGGYTF	YLQPRTFLL	known
CASSPDIQAFF	YLQPRTFLL	known
CASSWDIEAFF	YLQPRTFLL	known
CASSQDIEQYF	YLQPRTFLL	known
CANQDANTGELFF	YLQPRTFLL	known
CASSELNTGELFF	YLQPRTFLL	known
CASTGLNTGELFF	YLQPRTFLL	known
CASSLTGGGNTGELFF	YLQPRTFLL	known
CSARVGERAVNTGELFF	YLQPRTFLL	known
CASSQDIEAFF	YLQPRTFLL	known
CASSEIGGGNTGELFF	YLQPRTFLL	known
CASNHANTGELFF	YLQPRTFLL	known
CASSADVEAFF	YLQPRTFLL	known
CASTSLNTGELFF	YLQPRTFLL	known
CSARDSRAQNTGELFF	YLQPRTFLL	known
CASSPLAGGNTGELFF	YLQPRTFLL	known
CASSGTNQNIQYF	YLQPRTFLL	known
CASSQLAGGNTGELFF	YLQPRTFLL	known
CASTQDIEAFF	YLQPRTFLL	known
CASQDRNTGELFF	YLQPRTFLL	known
CAWSVVTDEHNEQFF	YLQPRTFLL	known
CASTDLDTGELFF	YLQPRTFLL	known
CAWSVLAGGNTGELFF	YLQPRTFLL	known
CASSPDIEDFF	YLQPRTFLL	known
CASSLGGAGGADTQYF	RLQSLQTYV	known
CASSYEKGIMNTEAFF	RLQSLQTYV	known
CATYIGNTGELFF	RLQSLQTYV	known
CASSVPGDNEQYF	RLQSLQTYV	known
CAWSVGAGMKYGYTF	RLQSLQTYV	known
CSVEGDSYEQYF	RLQSLQTYV	known
CASSQDWRAGAYNEQFF	RLQSLQTYV	known
CASSELLAGGLETQYF	RLQSLQTYV	known
CAASEMNTGELFF	YLQPRTFLL	known
CAKGTANTGELFF	YLQPRTFLL	known
CANQDRTSGELFF	YLQPRTFLL	known
CARERDRNTGELFF	YLQPRTFLL	known
CASEDRNTGELFF	YLQPRTFLL	known
CASGDDNTGELFF	YLQPRTFLL	known
CASGPDLGYTF	YLQPRTFLL	known
CASGTLNSLVAFF	YLQPRTFLL	known
CASIGLNTGELFF	YLQPRTFLL	known
CASIPDRNTGELFF	YLQPRTFLL	known
CASNNQNTGELFF	YLQPRTFLL	known
CASREGNTGELFF	YLQPRTFLL	known
CASRGGAELNTGELFF	YLQPRTFLL	known
CASRPTGLAENTGELFF	YLQPRTFLL	known
CASRRGFEQYF	YLQPRTFLL	known
CASSADIQQYF	YLQPRTFLL	known
CASSASYYEQYF	YLQPRTFLL	known
CASSDGNTGELFF	YLQPRTFLL	known
CASSDLDGGEAFF	YLQPRTFLL	known
CASSDTNTGELFF	YLQPRTFLL	known
CASSERNSLEAFF	YLQPRTFLL	known
CASSESNTGELFF	YLQPRTFLL	known
CASSGLNTGELFF	YLQPRTFLL	known
CASSLDIETYF	YLQPRTFLL	known
CASSPLNGGNTGELFF	YLQPRTFLL	known
CASSQRNDLKAFF	YLQPRTFLL	known
CASSSDIQQFF	YLQPRTFLL	known
CASSTLNSLEAFF	YLQPRTFLL	known
CATTDLNTGELFF	YLQPRTFLL	known
CATTGNWNTGELFF	YLQPRTFLL	known
CAVLAEQNTGELFF	YLQPRTFLL	known
CSARDHKAMNTGELFF	YLQPRTFLL	known
CSARDLGRGWNTGELFF	YLQPRTFLL	known
CSARDQWAANTGELFF	YLQPRTFLL	known
CSARDRLAQNTGELFF	YLQPRTFLL	known
CSARDSVAVNTGELFF	YLQPRTFLL	known
CSARSRQGQNTGELFF	YLQPRTFLL	known
CSGWQPQHF	YLQPRTFLL	known
CSVGTLNTGELFF	YLQPRTFLL	known
CATTERDQETQYF	RLQSLQTYV	known
CASSLGTGHQPQHF	RLQSLQTYV	known
CASTEGTGWTEAFF	RLQSLQTYV	known
CASSLGTGYQPQHF	RLQSLQTYV	known
CASSPPTSGTANEQFF	RLQSLQTYV	known
CSASPPGTSVNNEQFF	RLQSLQTYV	known
CSALTPALAGGVPETQYF	RLQSLQTYV	known
CATSGGTGHQPQHF	RLQSLQTYV	known
CASSQDEYNTGELFF	RLQSLQTYV	known
CAWSAGQGMNTEAFF	RLQSLQTYV	known
CAWSGGQIMNTEAFF	RLQSLQTYV	known
CASSILAGAADTQYF	RLQSLQTYV	known
CASSPGTGWAEAFF	RLQSLQTYV	known
CALGDLNTGELFF	YLQPRTFLL	known
CASSPLGGGNTGELFF	YLQPRTFLL	known
CATQGLNTGELFF	YLQPRTFLL	known
CSARDDRAQNTGELFF	YLQPRTFLL	known
CASIDENTGELFF	YLQPRTFLL	known
CSVDADHNTGELFF	YLQPRTFLL	known
CASSNANTGELFF	YLQPRTFLL	known
CAIGDENTGELFF	YLQPRTFLL	known
CASQATNTGELFF	YLQPRTFLL	known
CALGSSNTGELFF	YLQPRTFLL	known
CSARDGLAMNTGELFF	YLQPRTFLL	known
CAGGDSNTGELFF	YLQPRTFLL	known
CSVGDRNNLELFF	YLQPRTFLL	known
CARGLADTGELFF	YLQPRTFLL	known
CASLRDMNTGELFF	YLQPRTFLL	known
CSARGLAGSNTGELFF	YLQPRTFLL	known
CASMEENTGELFF	YLQPRTFLL	known
CASSTPRKEWGRAEAFF	YLQPRTFLL	known
CSVEEQNTGELFF	YLQPRTFLL	known
CASSPEIEAFF	YLQPRTFLL	known
CASSPDMNTGELFF	YLQPRTFLL	known
CASSVPDRANTGELFF	YLQPRTFLL	known
CSARDLAAQNTGELFF	YLQPRTFLL	known
CASGDENTGELFF	YLQPRTFLL	known
CANRDTDTQYF	YLQPRTFLL	known
CSAEPGTSGRDDLTQYF	YLQPRTFLL	known
CASSDSYGYTF	YLQPRTFLL	known
CASSYRNSLEQFF	YLQPRTFLL	known
CAIGDRSSGEQYF	YLQPRTFLL	known
CSAHGDLNTGELFF	YLQPRTFLL	known
CASSPEDTQYF	YLQPRTFLL	known
CACQELNTGELFF	YLQPRTFLL	known
CASSVDIEAFF	YLQPRTFLL	known
CALLLDWDTGELFF	YLQPRTFLL	known
CAGGVNPNTGELFF	YLQPRTFLL	known
CASQQANTGELFF	YLQPRTFLL	known
CASGTANTGELFF	YLQPRTFLL	known
CASMDQNTGELFF	YLQPRTFLL	known
CAWSLAGMGETQYF	YLQPRTFLL	known
CASSLGTGGDLHF	YLQPRTFLL	known
CAWSLLNDLEAFF	YLQPRTFLL	known
CATLAEMNTGELFF	YLQPRTFLL	known
CSARDSKGNGWNTGELFF	YLQPRTFLL	known
CASRAANEQFF	FIAGLIAIV	known
CASGEGNTGELFF	YLQPRTFLL	known
CASQLMNTGELFF	YLQPRTFLL	known
CAEGELNTGELFF	YLQPRTFLL	known
CASGEENTGELFF	YLQPRTFLL	known
CSARDHRGANTGELFF	YLQPRTFLL	known
CASIDQNTGELFF	YLQPRTFLL	known
CASIANRNTGELFF	YLQPRTFLL	known
CATGGLNTGELFF	YLQPRTFLL	known
CASQNENTGELFF	YLQPRTFLL	known
CASTDLNTGELFF	YLQPRTFLL	known
CASSPDIEQFF	YLQPRTFLL	known
CSARDGWDHNTGELFF	YLQPRTFLL	known
CSARDVEGMNTGELFF	YLQPRTFLL	known
CASSVQNTGELFF	YLQPRTFLL	known
CALWKGGRENTGELFF	YLQPRTFLL	known
CAIGDRNTGELFF	YLQPRTFLL	known
CAPGDLNTGELFF	YLQPRTFLL	known
CSARDERAVNTGELFF	YLQPRTFLL	known
CASQEANTGELFF	YLQPRTFLL	known
CASSDLDTGELFF	YLQPRTFLL	known
CASGTANTGELFF	YLQPRTFLL	known
CASSSQNTGELFF	YLQPRTFLL	known
CSVLEMNTGELFF	YLQPRTFLL	known
CASLSQNTGELFF	YLQPRTFLL	known
CASSEGLGGEQYF	YLQPRTFLL	known
CASSPLAGGNTGELFF	YLQPRTFLL	known
CAMQEMNTGELFF	YLQPRTFLL	known
CAAQMTNTGELFF	YLQPRTFLL	known
CAITDLNTGELFF	YLQPRTFLL	known
CATQNLNTGELFF	YLQPRTFLL	known
CASNPPPGDSENTGELFF	YLQPRTFLL	known
CSARDGLAQNTGELFF	YLQPRTFLL	known
CATQVDQNTGELFF	YLQPRTFLL	known
CATQGPSEINTGELFF	YLQPRTFLL	known
CASNDLNTGELFF	YLQPRTFLL	known
CATQGLNTGELFF	YLQPRTFLL	known
CATHELNTGELFF	YLQPRTFLL	known
CASSPDGEQYF	YLQPRTFLL	known
CASSSQNTAEAFF	YLQPRTFLL	known
CAWSDHNSKELFF	YLQPRTFLL	known
CATEDRNTGELFF	YLQPRTFLL	known
CASTDRDTETQYF	RLQSLQTYV	known
CASSQGDGANVLTF	RLQSLQTYV	known
CASSQGQGNIQYF	RLQSLQTYV	known
CVRQDRNTGELFF	RLQSLQTYV	known
CASSSGLALAEQYF	VLNDILSRL	known
CAIRTSGMLNTGELFF	YLQPRTFLL	known
CASGRQNTGELFF	YLQPRTFLL	known
CASGTQNTGELFF	YLQPRTFLL	known
CASQGLNTGELFF	YLQPRTFLL	known
CASSADIEQFF	YLQPRTFLL	known
CATQDRNTGELFF	YLQPRTFLL	known
CATSNLNTGELFF	YLQPRTFLL	known
CSARDAVAANTGELFF	YLQPRTFLL	known
CSARDEVAHNTGELFF	YLQPRTFLL	known
CSCGNANTGELFF	YLQPRTFLL	known
CATSDLDSGELFF	YLQPRTFLL	known
CASSDGTSNEQYF	YLQPRTFLL	known
CSARDAEGQNTGELFF	YLQPRTFLL	known
CASSEWIQETQYF	YLQPRTFLL	known
CASSDDIEAFF	YLQPRTFLL	known
CAGQRANTGELFF	YLQPRTFLL	known
CSARGELAVNTGELFF	YLQPRTFLL	known
CATMDDLNSGELFF	YLQPRTFLL	known
CAPQDLDTGELFF	YLQPRTFLL	known
CASSPTAGGDTGELFF	YLQPRTFLL	known
CAAQDSNTGELFF	YLQPRTFLL	known
CAGGRGNTGELFF	YLQPRTFLL	known
CASSPLVSRNTGELFF	YLQPRTFLL	known
CASSPPGGGNTGELFF	YLQPRTFLL	known
CAIQYANTGELFF	YLQPRTFLL	known
CASSLDSEQFF	YLQPRTFLL	known
CAIADANTGELFF	YLQPRTFLL	known
CASSEGTSGEQYF	YLQPRTFLL	known
CASSDSLDGYTF	YLQPRTFLL	known
CSARTDHNTGELFF	YLQPRTFLL	known
CATSTENTGELFF	YLQPRTFLL	known
CASSDSEGHNTGELFF	YLQPRTFLL	known
CASGEANTGELFF	YLQPRTFLL	known
CSARGGLSQNTGELFF	YLQPRTFLL	known
CASSLDILAFF	YLQPRTFLL	known
CASNELNTGELFF	YLQPRTFLL	known
CASSSDIEQFF	YLQPRTFLL	known
CATMPDRNTGELFF	YLQPRTFLL	known
CAAQATNTGELFF	YLQPRTFLL	known
CASSDANTGELFF	YLQPRTFLL	known
CASSLALANEQFF	YLQPRTFLL	known
CASNNLNTGELFF	YLQPRTFLL	known
CASSARNSIEAFF	YLQPRTFLL	known
CSARTGDDWNTGELFF	YLQPRTFLL	known
CASMTHNTGELFF	YLQPRTFLL	known
CAASDPNTGELFF	YLQPRTFLL	known
CASSLGLYGEQYF	YLQPRTFLL	known
CATEYTNTGELFF	YLQPRTFLL	known
CSARDGTGWNTGELFF	YLQPRTFLL	known
CAPTPDQNTGELFF	YLQPRTFLL	known
CATGSANTGELFF	YLQPRTFLL	known
CASSDLTGGEAFF	YLQPRTFLL	known
CASNSQNTGELFF	YLQPRTFLL	known
CASSNSFGYTF	YLQPRTFLL	known
CASSEANTGELFF	YLQPRTFLL	known
CASSPDITQYF	YLQPRTFLL	known
CASSPTAGGNTGELFF	YLQPRTFLL	known
CASSDLDNLVAFF	YLQPRTFLL	known
CAGADSNTGELFF	YLQPRTFLL	known
CAGQNLNTGELFF	YLQPRTFLL	known
CASRGLAEQNTGELFF	YLQPRTFLL	known
CAAAERNTGELFF	YLQPRTFLL	known
CSARDEAGQNTGELFF	YLQPRTFLL	known
CASPEANTGELFF	YLQPRTFLL	known
CSARDGQGMNTGELFF	YLQPRTFLL	known
CASSNSYGYTF	YLQPRTFLL	known
CASRDIHQQNTGELFF	YLQPRTFLL	known
CAGGDPNTGELFF	YLQPRTFLL	known
CASSDDNTGELFF	YLQPRTFLL	known
CASTRDIEAFF	YLQPRTFLL	known
CATQGWDTGELFF	YLQPRTFLL	known
CASSLVQGGNTGELFF	YLQPRTFLL	known
CASSIIGGGNTGELFF	YLQPRTFLL	known
CAAGVENTGELFF	YLQPRTFLL	known
CASQDSNTGELFF	YLQPRTFLL	known
CASSYQNTGELFF	YLQPRTFLL	known
CASSPPGAGNTGELFF	YLQPRTFLL	known
CASYDLNTGELFF	YLQPRTFLL	known
CAVQDSNTGELFF	YLQPRTFLL	known
CSARDYRQTNTGELFF	YLQPRTFLL	known
CAIQESNTGELFF	YLQPRTFLL	known
CASYSGRALTEAFF	YLQPRTFLL	known
CSARGESDQNTGELFF	YLQPRTFLL	known
CARQDTNTGELFF	YLQPRTFLL	known
CSARDLAGENTGELFF	YLQPRTFLL	known
CATQRTNTGELFF	YLQPRTFLL	known
CATQAVNTGELFF	YLQPRTFLL	known
CSARGWGNEANTGELFF	YLQPRTFLL	known
CASRSRVEQNTGELFF	YLQPRTFLL	known
CSARDFNSWNTGELFF	YLQPRTFLL	known
CSARDQAAQNTGELFF	YLQPRTFLL	known
CSVAGFLAVYNEQFF	YLQPRTFLL	known
CASSFLAGGNTGELFF	YLQPRTFLL	known
CASQYSNTGELFF	YLQPRTFLL	known
CASSLVPEEQYF	YLQPRTFLL	known
CANGKANTGELFF	YLQPRTFLL	known
CAIQDLNTGELFF	YLQPRTFLL	known
CARGESNTGELFF	YLQPRTFLL	known
CASTDMNTGELFF	YLQPRTFLL	known
CAARDQRDLNTGELFF	YLQPRTFLL	known
CASGDLDSIEAFF	YLQPRTFLL	known
CASQDQNTGELFF	YLQPRTFLL	known
CASSHTNTGELFF	YLQPRTFLL	known
CSVEEDRNTGELFF	YLQPRTFLL	known
CASSDIDTGELFF	YLQPRTFLL	known
CARGDQNTGELFF	YLQPRTFLL	known
CASSDTTRQNTGELFF	YLQPRTFLL	known
CASNDLNTGELFF	YLQPRTFLL	known
CSARDPPRVNTGELFF	YLQPRTFLL	known
CSARDQYRMNTGELFF	YLQPRTFLL	known
CASSLVAGGNTGELFF	YLQPRTFLL	known
CSVTWDRNTGELFF	YLQPRTFLL	known
CASLVQENTGELFF	YLQPRTFLL	known
CASSEIDTGELFF	YLQPRTFLL	known
CASSGGQGANTGELFF	YLQPRTFLL	known
CASSELDSGELFF	YLQPRTFLL	known
CSARDPLAINTGELFF	YLQPRTFLL	known
CSARDALAQNTGELFF	YLQPRTFLL	known
CSAQGDLNTGELFF	YLQPRTFLL	known
CATQRANTGELFF	YLQPRTFLL	known
CSARTSGGQNTGELFF	YLQPRTFLL	known
CAVQGMNTGELFF	YLQPRTFLL	known
CATSDSNTGELFF	YLQPRTFLL	known
CASSPDRNTGELFF	YLQPRTFLL	known
CASYFQDTGELFF	YLQPRTFLL	known
CASSLQNTGELFF	YLQPRTFLL	known
CAKQGLDTGELFF	YLQPRTFLL	known
CAPGVPNTGELFF	YLQPRTFLL	known
CASSDSLGYTF	YLQPRTFLL	known
CASSPLQGGNTGELFF	YLQPRTFLL	known
CATGELNTGELFF	YLQPRTFLL	known
CSAQTDRNLGGYTF	YLQPRTFLL	known
CASSPTGGGNTGELFF	YLQPRTFLL	known
CSARGLAEANTGELFF	YLQPRTFLL	known
CASQDRNTGELFF	YLQPRTFLL	known
CSARDPWGINTGELFF	YLQPRTFLL	known
CSARDPSGVKLFF	YLQPRTFLL	known
CSARDSLAQNTGELFF	YLQPRTFLL	known
CASGDENTGELFF	YLQPRTFLL	known
CASSDSYGYTF	YLQPRTFLL	known
CASSLGISGELFF	YLQPRTFLL	known
CASSLDIEQYF	YLQPRTFLL	known
CASSIGDEQYF	YLQPRTFLL	known
CASSQVESADTQYF	YLQPRTFLL	known
CGELAQNTGELFF	YLQPRTFLL	known
CASSPDIDQFF	YLQPRTFLL	known
CASSLAGPNEQFF	YLQPRTFLL	known
CSARWGLLVNTGELFF	YLQPRTFLL	known
CASSPDIEQYF	YLQPRTFLL	known
CAISDGDWETQYF	YLQPRTFLL	known
CASSLGWDGNTDTQYF	YLQPRTFLL	known
CATTEGVAGELFF	YLQPRTFLL	known
CATQEGNTGELFF	YLQPRTFLL	known
CATQNMNTGELFF	YLQPRTFLL	known
CASSIDLADTQYF	YLQPRTFLL	known
CATQITNTGELFF	YLQPRTFLL	known
CASQILNTGELFF	YLQPRTFLL	known
CASPKRTGLSNTEAFF	YLQPRTFLL	known
CAINEQNTGELFF	YLQPRTFLL	known
CASSPRNSLEAFF	YLQPRTFLL	known
CASSDLDTGELFF	YLQPRTFLL	known
CASSELNGGNTGELFF	YLQPRTFLL	known
CSARDRQGQNTGELFF	YLQPRTFLL	known
CSARDFLGGYTF	YLQPRTFLL	known
CASSYSSYGSNQPQHF	YLQPRTFLL	known
CASSYKNTGELFF	YLQPRTFLL	known
CASQLQNTGELFF	YLQPRTFLL	known
CASQLVNTGELFF	YLQPRTFLL	known
CASSGLNTGELFF	YLQPRTFLL	known
CASQRMNTGELFF	YLQPRTFLL	known
CASSPDDGQPQHF	YLQPRTFLL	known
CASSFQDTGELFF	YLQPRTFLL	known
CASSPDIEAFF	YLQPRTFLL	known
CASSNDPNTGELFF	YLQPRTFLL	known
CASGEGNTGELFF	YLQPRTFLL	known
CASQNRDTGELFF	YLQPRTFLL	known
CSAEGDRNSLRTYF	YLQPRTFLL	known
CAISDYPGPKTQDTQYF	SPRWYFYYL	known
CASSLGTGPFSEQYF	SPRWYFYYL	known
CASSQSPGGTEAFF	SPRWYFYYL	known
CASKLWASGSGYGYTF	SPRWYFYYL	known
CASSPLTGPPVAKNIQYF	SPRWYFYYL	known
CASSLTGSRNQPQHF	SPRWYFYYL	known
CSASGRDSVYEQYF	SPRWYFYYL	known
CSAATRDRVYEQYF	SPRWYFYYL	known
CASNLRVDEQFF	SPRWYFYYL	known
CASSYGMGGRASYNEQFF	SPRWYFYYL	known
CASSSFPGPQPNSPLHF	SPRWYFYYL	known
CASSYLPGPPAGEQYF	SPRWYFYYL	known
CASRGGGTEAFF	SPRWYFYYL	known
CASSSLASSSYNEQFF	SPRWYFYYL	known
CASSGLTSDRAKYGYTF	SPRWYFYYL	known
CASSYSNPGQGAEAFF	SPRWYFYYL	known
CASIPTRDTGELFF	SPRWYFYYL	known
CAAVRPSTIYF	SPRWYFYYL	known
CASSQVLGPGELFF	SPRWYFYYL	known
CASSEAISTRAQHF	SPRWYFYYL	known
CAWDYLTLNTGELFF	SPRWYFYYL	known
CASMGLAGGGEQYF	SPRWYFYYL	known
CASSTRTGGFSDTQYF	SPRWYFYYL	known
CASSLETGRNIQYF	SPRWYFYYL	known
CSAWRGRGADNEQFF	SPRWYFYYL	known
CASSPGTSYEQYF	SPRWYFYYL	known
CASSHLMAGGRYEQYF	SPRWYFYYL	known
CASSQWSGPSYEQYF	SPRWYFYYL	known
CSARDTAGATYNEQFF	SPRWYFYYL	known
CASSYYGVNEQFF	SPRWYFYYL	known
CASSLLAGGRAADKEKLFF	SPRWYFYYL	known
CSVETPGVYEQYF	SPRWYFYYL	known
CASSQDQGAGSPLHF	SPRWYFYYL	known
CSVPGTGNEAFF	SPRWYFYYL	known
CSAGGLAAPGELFF	SPRWYFYYL	known
CSVVPLAGPYEQYF	SPRWYFYYL	known
CASSPLLGGGFAEQYF	SPRWYFYYL	known
CSAKPRENWNSPLHF	SPRWYFYYL	known
CASTPKPFSGANVLTF	SPRWYFYYL	known
CASTGPGRRSGNTIYF	SPRWYFYYL	known
CASTPMGLEVLDTQYF	SPRWYFYYL	known
CASSDRGMGETQYF	SPRWYFYYL	known
CSVVGTGGPETQYF	SPRWYFYYL	known
CASSQGPYSGNTIYF	SPRWYFYYL	known
CASSRVPQGTGSYEQYF	SPRWYFYYL	known
CASSRRATGNYQPQHF	SPRWYFYYL	known
CSVERGDTQYF	SPRWYFYYL	known
CASSPADRTSLEGETQYF	SPRWYFYYL	known
CASSETGGYEQYF	NYNYLYRLF	known
CASSEGQGYEQFF	NYNYLYRLF	known
CASSEGQGYEQYF	NYNYLYRLF	known
CASSETGGYEQYF	NYNYLYRLF	known
CASSEFRSYEQYF	NYNYLYRLF	known
CASSERTGYEQYF	NYNYLYRLF	known
CASSLLGGYEQYF	NYNYLYRLF	known
CASSRGSGVSYEQYF	NYNYLYRLF	known
CASASGQGYEQYF	NYNYLYRLF	known
CASSQGPGPYEQYF	NYNYLYRLF	known
CASSEWGQGVAYGYTF	NYNYLYRLF	known
CASSVGATGAYEQYF	QYIKWPWYI	known
CASSFHPGQDRGNSPLHF	QYIKWPWYI	known
CSARTISQGAHYEQYF	QYIKWPWYI	known
CSVEDPMGVGTEAFF	QYIKWPWYI	known
