CDR3b	epitope-pred	epitope-true
CASSPLTGSPVAKNIQYF	SPRWYFYYL	SPRWYFYYL
CASSLSYRGNTEAFF	YLQPRTFLL	SPRWYFYYL
CASSEIAGGNTGELFF	YLQPRTFLL	YLQPRTFLL
CANGSPNTGELFF	YLQPRTFLL	YLQPRTFLL
CASSPEDEQYF	YLQPRTFLL	YLQPRTFLL
CASSPEDIQYF	YLQPRTFLL	YLQPRTFLL
CASSADIEQYF	YLQPRTFLL	YLQPRTFLL
CASSYARNTGELFF	YLQPRTFLL	NLSDRVVFV
CASFQDQNTGELFF	YLQPRTFLL	YLQPRTFLL
CASSDQNTGELFF	YLQPRTFLL	YLQPRTFLL
CAIASQNTGELFF	YLQPRTFLL	YLQPRTFLL
CSARDRVGQNTGELFF	YLQPRTFLL	YLQPRTFLL
CSARDQQGQNTGELFF	YLQPRTFLL	YLQPRTFLL
CSARTPMGQNTGELFF	YLQPRTFLL	YLQPRTFLL
CSARDPTQQNTGELFF	YLQPRTFLL	YLQPRTFLL
CSARDAGGQNTGELFF	YLQPRTFLL	YLQPRTFLL
CASTLDQNTGELFF	YLQPRTFLL	YLQPRTFLL
CSVGEQNTGELFF	YLQPRTFLL	YLQPRTFLL
CSARDSRGQNTGELFF	YLQPRTFLL	YLQPRTFLL
CSARDQASQNTGELFF	YLQPRTFLL	YLQPRTFLL
CATSRAGQNTGELFF	YLQPRTFLL	RSRNSSRNL
CSASSRDSQNTGELFF	YLQPRTFLL	YLQPRTFLL
CATPRQNTGELFF	YLQPRTFLL	VLLAPLLSA
CSARDQPAQNTGELFF	YLQPRTFLL	YLQPRTFLL
CSVQVLNTGELFF	YLQPRTFLL	YLQPRTFLL
CASRDRDSLNTGELFF	YLQPRTFLL	YLQPRTFLL
CSARDDRALNTGELFF	YLQPRTFLL	YLQPRTFLL
CASGDLNTGELFF	YLQPRTFLL	YLQPRTFLL
CSVGELNTGELFF	YLQPRTFLL	YLQPRTFLL
CASEDLNTGELFF	FTSDYYQLY	YLQPRTFLL
CAEQDLNTGELFF	YLQPRTFLL	YLQPRTFLL
CASISLNTGELFF	YLQPRTFLL	YLQPRTFLL
CASSFTGLNTGELFF	YLQPRTFLL	NPANNAAIV
CASGSLNTGELFF	YLQPRTFLL	YLQPRTFLL
CATTELNTGELFF	YLQPRTFLL	YLQPRTFLL
CSARDERALNTGELFF	YLQPRTFLL	YLQPRTFLL
CAEGNLNTGELFF	YLQPRTFLL	YLQPRTFLL
CARGSLNTGELFF	YLQPRTFLL	YLQPRTFLL
CASGELNTGELFF	YLQPRTFLL	YLQPRTFLL
CASPDLNTGELFF	FTSDYYQLY	YLQPRTFLL
CASGNLNTGELFF	YLQPRTFLL	YLQPRTFLL
CASSLRGQLNTGELFF	YLQPRTFLL	SPRWYFYYL
CANQDLNTGELFF	YLQPRTFLL	YLQPRTFLL
CSVMDSLNTGELFF	YLQPRTFLL	YLQPRTFLL
CAWIELNTGELFF	YLQPRTFLL	YLQPRTFLL
CASMDLNTGELFF	FTSDYYQLY	YLQPRTFLL
CATQTLNTGELFF	YLQPRTFLL	YLQPRTFLL
CSATRDLNTGELFF	YLQPRTFLL	YLQPRTFLL
CAGQGLNTGELFF	YLQPRTFLL	YLQPRTFLL
CASNPDRNTGELFF	YLQPRTFLL	YLQPRTFLL
CASSVGQGYEQYF	NYNYLYRLF	NYNYLYRLF
CASSEGRGYEQFF	NYNYLYRLF	NYNYLYRLF
CASSETQGYEQFF	NYNYLYRLF	NYNYLYRLF
CSARDGQAMNTGELFF	YLQPRTFLL	YLQPRTFLL
CASRGPGQMNTGELFF	YLQPRTFLL	YLQPRTFLL
CAGQEMNTGELFF	YLQPRTFLL	YLQPRTFLL
CASRGDREMNTGELFF	YLQPRTFLL	YLQPRTFLL
CAWLRDMNTGELFF	YLQPRTFLL	YLQPRTFLL
CASRGGQGMNTGELFF	YLQPRTFLL	YLQPRTFLL
CATQDMNTGELFF	YLQPRTFLL	YLQPRTFLL
CASAEMNTGELFF	YLQPRTFLL	YLQPRTFLL
CSARDLAGMNTGELFF	YLQPRTFLL	YLQPRTFLL
CASSPDLGLAKREETQYF	YLQPRTFLL	ATSRMLSYY
CASSPDLGVGHYGYTF	YLQPRTFLL	SSSKLWAQY
CASRPDLGELFF	YLQPRTFLL	IFNGECPNF
CAMRTDPNTGELFF	YLQPRTFLL	YLQPRTFLL
CASLGDPNTGELFF	YLQPRTFLL	YLQPRTFLL
CASSGGRNTEAFF	RLQSLQTYV	KTFPPTEPK
CASSEARTGEEKLFF	YLQPRTFLL	AVASKILGL
CAISELNQPQHF	YLQPRTFLL	YTNDKACPL
CASSPPPSPRELNTDTQYF	YLQPRTFLL	QYIKWPWYI
CASSELNGFEAFF	YLQPRTFLL	YLQPRTFLL
CATGESNTGELFF	YLQPRTFLL	YLQPRTFLL
CAEGERNTGELFF	YLQPRTFLL	YLQPRTFLL
CASSQDLPGLDLNEQFF	YLQPRTFLL	YLDAYNMMI
CATSDLNGGGYTF	YLQPRTFLL	SPRWYFYYL
CASSQDLNQPQHF	YLQPRTFLL	SIIAYTMSL
CANGDLNSGELFF	YLQPRTFLL	YLQPRTFLL
CATSRGGNQPQHF	LTDEMIAQY	YMPYFFTLL
CASSLNRANTEAFF	LTDEMIAQY	SPRWYFYYL
CATGGDHNTGELFF	YLQPRTFLL	YLQPRTFLL
CSARNDRGHNTGELFF	YLQPRTFLL	YLQPRTFLL
CASSADIGAFF	YLQPRTFLL	YLQPRTFLL
CASSSEIEAFF	YLQPRTFLL	YLQPRTFLL
CASGHPNDLKAFF	YLQPRTFLL	YLQPRTFLL
CSVSDRNDLVAFF	YLQPRTFLL	YLQPRTFLL
CASSPDILAFF	YLQPRTFLL	YLQPRTFLL
CASSPDILHTF	YLQPRTFLL	YLQPRTFLL
CASRGQGEEKLFF	YLQPRTFLL	TYHWLLLTI
CASSEQGANYEQYF	TTDPSFLGRY	LFFSDVTWF
CASSLGSEQYF	YLQPRTFLL	SPRWYFYYL
CAQGDANTGELFF	YLQPRTFLL	YLQPRTFLL
CASTDANTGELFF	YLQPRTFLL	YLQPRTFLL
CAKDDANTGELFF	YLQPRTFLL	YLQPRTFLL
CASTELDTGELFF	YLQPRTFLL	YLQPRTFLL
CASADLDTGELFF	YLQPRTFLL	YLQPRTFLL
CATTDLDSGELFF	YLQPRTFLL	YLQPRTFLL
CASSPIAGGNTGELFF	YLQPRTFLL	YLQPRTFLL
CASQDINTGELFF	YLQPRTFLL	YLQPRTFLL
CAIQDSNTGELFF	YLQPRTFLL	YLQPRTFLL
CARQDSNTGELFF	YLQPRTFLL	YLQPRTFLL
CADQDSNTGELFF	YLQPRTFLL	YLQPRTFLL
CASSLAGTEAFF	LLYDANYFL	SPRWYFYYL
CASSSLTSGAYNEQFF	SPRWYFYYL	SPRWYFYYL
CASSQDHEQYF	YLQPRTFLL	TTIQTIVEV
CASSQDLEAFF	YLQPRTFLL	FTSDYYQLY
CASSQDIYAFF	YLQPRTFLL	YLQPRTFLL
CASSTDRENTEAFF	YLQPRTFLL	TGAIKLDDK
CASGDGNTGELFF	YLQPRTFLL	YLQPRTFLL
CASSPPGLGNTGELFF	YLQPRTFLL	YLQPRTFLL
CASRKAGQNYEQYF	YLQPRTFLL	IPIQASLPF
CSARVAHYEQYF	QYIKWPWYI	MSDVKCTSV
CSVETDRNTVEAFF	YLQPRTFLL	YLQPRTFLL
CASSSDDMRNTGELFF	YLQPRTFLL	YLQPRTFLL
CSAWDRNTEAFF	YLQPRTFLL	YVYSRVKNL
CASSGNRDRNTGELFF	YLQPRTFLL	YLQPRTFLL
CASHSDRNTGELFF	YLQPRTFLL	YLQPRTFLL
CASSQRNTGELFF	YLQPRTFLL	YLQPRTFLL
CSAQWDRNTGELFF	YLQPRTFLL	YLQPRTFLL
CASDRDRNTGELFF	YLQPRTFLL	YLQPRTFLL
CASSGLAERNTGELFF	YLQPRTFLL	YLQPRTFLL
CATDRNTEAFF	YLQPRTFLL	KTFPPTEPK
CSVDRDRNTGELFF	YLQPRTFLL	YLQPRTFLL
CSAHRDRNTGELFF	YLQPRTFLL	YLQPRTFLL
CSVSRDRNTGELFF	YLQPRTFLL	YLQPRTFLL
CSVEGDRNTGELFF	YLQPRTFLL	YLQPRTFLL
CSARDRRVDSRNTGELFF	YLQPRTFLL	SPRWYFYYL
CASSSQNGQPQHF	YLQPRTFLL	YYQLYSTQL
CSARDLWGENTGELFF	YLQPRTFLL	YLQPRTFLL
CASRDLAGWNTGELFF	YLQPRTFLL	YLQPRTFLL
CSANSLAESTDTQYF	YLQPRTFLL	AIMTRCLAV
CASSFLATLNSGNTIYF	YLQPRTFLL	FLNGSCGSV
CATSRQSGPTLNSGNTIYF	YLQPRTFLL	SPRWYFYYL
CASSPDVEAFF	YLQPRTFLL	YLQPRTFLL
CASSHTGGYEQFF	NYNYLYRLF	NYNYLYRLF
CASSSANTGELFF	YLQPRTFLL	DYTEISFML
CAWSLSRGQETQYF	FTSDYYQLY	RPDTRYVLM
CSVTRDSNTGELFF	YLQPRTFLL	YLQPRTFLL
CASSPSYRGNNSPLHF	YLQPRTFLL	SPRWYFYYL
CASSLWNTGELFF	YLQPRTFLL	SPRWYFYYL
CASSSATFFEQNYGYTF	YLQPRTFLL	YLQPRTFLL
CASSLGAQGYNEQFF	NYNYLYRLF	YLAVFDKNL
CASQQGNTGELFF	YLQPRTFLL	YLQPRTFLL
CSAPGLAGELFF	TTDPSFLGRY	MEVTPSGTWL
CASSLSYRGNSPLHF	YLQPRTFLL	SPRWYFYYL
CARGAANTGELFF	YLQPRTFLL	YLQPRTFLL
CAPGSANTGELFF	YLQPRTFLL	YLQPRTFLL
CASLNRANTEAFF	LTDEMIAQY	VLLFLAFVV
CASITDRERNEKLFF	YLQPRTFLL	ALNLGETFV
CATSTGGQPQHF	AEVQIDRLI	SPRWYFYYL
CASSTLATNEKLFF	TTDPSFLGRY	SPRWYFYYL
CASSLGQTEAFF	LLYDANYFL	LLYDANYFL
CAIQEANTGELFF	YLQPRTFLL	YLQPRTFLL
CSASGSNTGELFF	YLQPRTFLL	FLPGVYSVI
CASSESYRGNTEAFF	YLQPRTFLL	SPRWYFYYL
CASQETNTGELFF	YLQPRTFLL	YLQPRTFLL
CASSERDSPGNVLTF	NNSYECDIPIGAGIC	SPRWYFYYL
CASSERASPGNVLTF	NNSYECDIPIGAGIC	SPRWYFYYL
CASSQSYRGNTEAFF	YLQPRTFLL	SPRWYFYYL
CASSPGHYSNQPQHF	NQKLIANQF	SPRWYFYYL
CSASPGQGYGYTF	NYNYLYRLF	FAFACPDGV
CSVSGGYGYTF	PTDNYITTY	SPRWYFYYL
CASSTDREGITPQHF	YLQPRTFLL	ALSKGVHFV
CASSIGGTEAFF	LLYDANYFL	LLYDANYFL
CASSAGTGAYGYTF	YLQPRTFLL	QYIKWPWYI
CASSAGQNSYEQYF	YLQPRTFLL	SPRWYFYYL
CASSLAAGQNNEQFF	YLQPRTFLL	KTFPPTEPK
CASSFGTSGEQFF	YLQPRTFLL	KPASRELKV
CASSYLAGGYNEQFF	SPRWYFYYL	SPRWYFYYL
CASRGTREESNTGELFF	YLQPRTFLL	LPSYAAFAT
CASSEGESNTGELFF	YLQPRTFLL	YLQPRTFLL
CASSSDIIAFF	YLQPRTFLL	YLQPRTFLL
CASSKRTDSYEQYF	PTDNYITTY	PTDNYITTY
CASSQVAGYEQYF	NYNYLYRLF	NYNYLYRLF
CSVGRMNTEAFF	VGGNYNYLYRLFRKS	LDDKDPNFK
CASSLSYRGNQPQHF	YLQPRTFLL	SPRWYFYYL
CASEATNTGELFF	YLQPRTFLL	KTFPPTEPK
CASSILAGGNTGELFF	YLQPRTFLL	YLQPRTFLL
CASRDRDSYEQYF	YLQPRTFLL	YLQPRTFLL
CSARDHGATNTGELFF	YLQPRTFLL	YLQPRTFLL
CASSDIDSGELFF	YLQPRTFLL	YLQPRTFLL
CASSPLFGGNTGELFF	YLQPRTFLL	YLQPRTFLL
CASSYANTGELFF	YLQPRTFLL	YLQPRTFLL
CATSRLAGGYNEQFF	SPRWYFYYL	SPRWYFYYL
CASSEWLQETQYF	YLQPRTFLL	YLQPRTFLL
CAISPGQGRYGYTF	YLQPRTFLL	FFSYFAVHF
CASSLGGGYQPQHF	RLQSLQTYV	KIYSKHTPI
CASSEGLGELFF	LTDEMIAQY	KTFPPTEPK
CASSYIDSLEAFF	TTDPSFLGRY	YLQPRTFLL
CASIKDSLESPFEAFF	TTDPSFLGRY	EIDPKLDNY
CASSLLDSLEQYF	TTDPSFLGRY	YLQPRTFLL
CASSQGAGAHYGYTF	QYIKWPWYI	VLSFCAFAV
CASSLTGNVNEQFF	VYFLQSINF	VMPLSAPTL
CASSEWRGYEQYF	NYNYLYRLF	NYNYLYRLF
CASSQGTDSYEQYF	PTDNYITTY	KWPWYIWLG
CASSDRRGTDTQYF	TTDPSFLGRY	VINGDRWFL
CASTGGYEQYF	YLQPRTFLL	YLRPRTFLL
CASSFAGSSYEQYF	LTDEMIAQY	FLLPSLATV
CASSLAGANEQFF	YLQPRTFLL	SPRWYFYYL
CASRVENTGELFF	YLQPRTFLL	YLQPRTFLL
CASSNGNTGELFF	YLQPRTFLL	YLQPRTFLL
CATSESGGYEQYF	NYNYLYRLF	NYNYLYRLF
CASSPDRNYGYTF	YLQPRTFLL	SQLGGLHLL
CASSERNHLEAFF	YLQPRTFLL	YLQPRTFLL
CASSLSYRGNNSPLHF	YLQPRTFLL	SPRWYFYYL
CASSEGDEQYF	YLQPRTFLL	YLQPRTFLL
CSARDRDRAYEQYF	QYIKWPWYI	QYIKWPWYI
CASSQQGGYEQFF	NYNYLYRLF	SPRWYFYYL
CSAGGGSGANVLTF	RLQSLQTYV	SMMILSDDA
CSARDIGTGAHYEQYF	QYIKWPWYI	QYIKWPWYI
CASSLQVNTEAFF	LTDEMIAQY	QYIKWPWYI
CASSLTSGYEQYF	PTDNYITTY	NYNYLYRLF
CATSLLSTGELFF	YLQPRTFLL	SPRWYFYYL
CSVTAQGYEQYF	NYNYLYRLF	TMADLVYAL
CASSPLAGGEEKKETQYF	YLQPRTFLL	SPRWYFYYL
CASSPSGTNTGELFF	YLQPRTFLL	FMCVEYCPI
CASSPPGHGNTGELFF	YLQPRTFLL	YLQPRTFLL
CASSYSYRGNDEQYF	YLQPRTFLL	SPRWYFYYL
CASSTSGGGEQYF	QYIKWPWYI	QYIKWPWYI
CASSPPSGGNTGELFF	YLQPRTFLL	YLQPRTFLL
CASSPTSGGNTGELFF	YLQPRTFLL	YTDINGNLH
CASRSGGTEAFF	SPRWYFYYL	SPRWYFYYL
CASSPPTGGNTGELFF	YLQPRTFLL	YLQPRTFLL
